Type,Name,Total Population,Male,Female,Under 5,5 to 9,10 to 14,15 to 19,20 to 24,25 to 34,35 to 44,45 to 54,55 to 59,60 to 64,65 to 74,75 to 84,Over 85,Median age,Households,Households with kids,Households with senior citizens,Avg household size,Avg family size,Total Housing Units,Occupied Housing Units,Vacant Housing,Rental or Vacation Housing,Owner-occupied Housing,Renter-occupied Housing
A,Virginia,7078515,3471895,3606620,461982,495084,495955,484065,480574,1036965,1200690,999256,358442,273169,432456,272611,87266,35.7,2699173,968736,565204,2.54,3.04,2904192,2699173,205019,54696,1837939,861234
A,Accomack County,38305,18590,19715,2336,2695,2655,2585,2175,4311,5716,5167,2212,2064,3505,2129,755,39.4,15299,5256,4569,2.45,2.96,19550,15299,4251,2585,11482,3817
A,Albemarle County,79236,38002,41234,4961,5608,5928,4735,4209,11129,13358,12071,4108,3209,5348,3413,1159,37.4,31876,10885,6768,2.44,2.99,33720,31876,1844,428,20991,10885
A,Alleghany County,12926,6450,6476,721,846,850,820,518,1508,1954,2038,926,720,1101,717,207,41.1,5149,1697,1397,2.46,2.85,5812,5149,663,220,4369,780
A,Amelia County,11400,5622,5778,716,774,857,776,535,1365,1969,1605,718,571,817,484,213,38.5,4240,1614,1058,2.66,3.07,4609,4240,369,66,3474,766
A,Amherst County,31894,15208,16686,1820,2075,2235,2518,1937,3907,4930,4613,1863,1599,2520,1415,462,38,11941,4251,3139,2.51,2.95,12958,11941,1017,176,9325,2616
A,Appomattox County,13705,6671,7034,842,959,974,937,644,1660,2152,1898,883,731,1128,679,218,39.1,5322,1928,1452,2.55,2.94,5828,5322,506,102,4315,1007
A,Arlington County,189453,95443,94010,10397,8741,7635,7640,16535,47675,32664,25841,8816,5747,8330,6914,2518,34,86352,18038,13296,2.15,2.96,90426,86352,4074,1526,37370,48982
A,Augusta County,65615,32995,32620,3715,4372,4687,4275,3039,8130,11414,10274,4048,3232,4868,2705,856,39,24818,8954,5918,2.56,2.94,26738,24818,1920,454,20628,4190
A,Bath County,5048,2532,2516,222,306,343,278,190,604,822,754,353,332,515,250,79,41.8,2053,614,596,2.34,2.8,2896,2053,843,684,1640,413
A,Bedford County,60371,30107,30264,3527,4117,4410,3543,2409,7305,10723,9711,3932,2956,4692,2363,683,39.7,23838,8334,5438,2.52,2.89,26841,23838,3003,1269,20637,3201
A,Bland County,6871,3747,3124,308,356,417,398,377,1000,1105,1123,419,375,560,323,110,40.3,2568,792,715,2.43,2.85,3161,2568,593,314,2212,356
A,Botetourt County,30496,15227,15269,1749,1892,2194,1937,1121,3358,5442,5242,1985,1564,2474,1205,333,40.7,11700,4129,2828,2.56,2.92,12571,11700,871,300,10268,1432
A,Brunswick County,18419,9776,8643,914,1004,1162,1242,1276,2692,2962,2601,1006,881,1532,871,276,38.1,6277,2051,1992,2.47,3,7541,6277,1264,415,4871,1406
A,Buchanan County,26978,13681,13297,1288,1582,1671,1925,1588,3666,4740,4305,1647,1474,1863,937,292,38.8,10464,3550,2383,2.46,2.87,11887,10464,1423,82,8672,1792
A,Buckingham County,15623,8574,7049,775,929,1165,935,863,2242,2748,2276,820,752,1159,726,233,38.2,5324,1866,1559,2.52,2.99,6290,5324,966,279,4144,1180
A,Campbell County,51078,24924,26154,2985,3457,3691,3232,2781,6795,8169,7507,2989,2593,4040,2230,609,38.3,20639,7055,4975,2.45,2.91,22088,20639,1449,126,15954,4685
A,Caroline County,22121,11011,11110,1381,1559,1602,1424,1153,2915,3696,3188,1318,1028,1569,960,328,37.7,8021,3048,2040,2.69,3.08,8889,8021,868,273,6571,1450
A,Carroll County,29245,14416,14829,1642,1707,1808,1620,1508,3842,4337,4365,1862,1581,2789,1648,536,40.7,12186,3705,3539,2.36,2.8,14680,12186,2494,1296,9958,2228
A,Charles City County,6926,3398,3528,388,421,428,466,352,786,1215,1207,456,333,557,248,69,39.9,2670,919,681,2.59,3.02,2895,2670,225,54,2268,402
A,Charlotte County,12472,5977,6495,689,894,913,830,605,1409,1860,1662,773,654,1158,795,230,40,4951,1652,1593,2.47,3,5734,4951,783,164,3840,1111
A,Chesterfield County,259903,126588,133315,17513,20637,22100,20365,12708,33702,47270,42597,13336,8668,12525,6742,1740,35.7,93772,40877,14796,2.73,3.11,97707,93772,3935,297,75874,17898
A,Clarke County,12652,6261,6391,660,916,888,733,498,1359,2318,1988,794,652,1024,604,218,40.6,4942,1625,1290,2.5,2.97,5388,4942,446,170,3737,1205
A,Craig County,5091,2588,2503,292,328,375,306,229,633,877,777,322,261,392,225,74,39.6,2060,693,520,2.45,2.88,2554,2060,494,329,1672,388
A,Culpeper County,34262,17411,16851,2186,2520,2569,2380,1920,4637,6020,4762,1818,1386,2289,1349,426,36.5,12141,4779,2852,2.68,3.08,12871,12141,730,148,8561,3580
A,Cumberland County,9017,4295,4722,564,654,664,549,460,1126,1395,1279,527,460,779,419,141,38.4,3528,1244,1007,2.55,3.03,4085,3528,557,141,2722,806
A,Dickenson County,16395,8017,8378,875,945,1079,1215,971,1961,2572,2589,959,856,1352,776,245,39.7,6732,2263,1782,2.42,2.88,7684,6732,952,115,5525,1207
A,Dinwiddie County,24533,12193,12340,1367,1719,1818,1521,1105,3151,4432,3704,1484,1238,1709,1039,246,38.5,9107,3434,2223,2.58,3.01,9707,9107,600,54,7214,1893
A,Essex County,9989,4730,5259,520,670,725,594,485,1183,1515,1487,575,502,904,604,225,40.3,3995,1291,1191,2.46,2.95,4926,3995,931,544,3087,908
A,Fairfax County,969749,481373,488376,67781,70076,68544,59762,52425,150257,178871,157350,53268,34597,44403,25493,6922,35.9,350714,134615,55435,2.74,3.2,359411,350714,8697,2098,248820,101894
A,Fauquier County,55139,27250,27889,3526,4160,4515,3869,2251,6365,10355,8692,3312,2305,3280,1865,644,37.8,19842,7887,4043,2.75,3.14,21046,19842,1204,326,15113,4729
A,Floyd County,13874,6849,7025,779,857,911,842,653,1774,2057,2141,908,746,1115,792,299,40.5,5791,1796,1579,2.39,2.83,6763,5791,972,417,4745,1046
A,Fluvanna County,20047,9305,10742,1294,1388,1346,1077,894,2799,3557,2772,1108,1012,1842,755,203,38.3,7387,2642,1909,2.59,2.93,8018,7387,631,220,6297,1090
A,Franklin County,47286,23306,23980,2569,2965,3185,3078,2539,5726,7605,7213,3127,2514,3964,2158,643,39.7,18963,6098,4780,2.44,2.84,22717,18963,3754,2598,15386,3577
A,Frederick County,59209,29620,29589,3825,4529,4654,3973,2786,7944,10924,8503,3201,2567,3667,2011,625,36.7,22097,8736,4439,2.64,3.02,23319,22097,1222,344,17752,4345
A,Giles County,16657,8141,8516,944,1007,1079,977,790,2203,2525,2429,1112,809,1456,1042,284,40.2,6994,2170,2050,2.37,2.85,7732,6994,738,227,5529,1465
A,Gloucester County,34780,17080,17700,2027,2566,2854,2470,1565,4113,6468,5067,1994,1548,2290,1311,507,38,13127,5078,2901,2.62,3.02,14494,13127,1367,459,10681,2446
A,Goochland County,16863,8494,8369,875,974,1105,898,622,2161,3250,2887,1165,817,1297,594,218,40.5,6158,2035,1500,2.51,2.88,6555,6158,397,94,5334,824
A,Grayson County,17917,9289,8628,856,1008,1032,944,1011,2534,2806,2618,1073,1000,1704,1001,330,40.5,7259,2087,2213,2.31,2.77,9123,7259,1864,1095,5912,1347
A,Greene County,15244,7560,7684,1149,1201,1245,900,699,2272,2784,2126,782,601,827,482,176,35.5,5574,2328,1014,2.71,3.07,5986,5574,412,221,4535,1039
A,Greensville County,11560,7130,4430,444,543,707,594,675,2095,2381,1755,599,445,769,420,133,38.1,3375,1204,992,2.51,2.99,3765,3375,390,62,2642,733
A,Halifax County,37355,17782,19573,2203,2549,2463,2313,1769,4325,5532,5542,2263,2023,3260,2330,783,40.7,15018,4967,4587,2.43,2.94,16953,15018,1935,310,11430,3588
A,Hanover County,86320,42479,43841,5611,6740,6878,6291,3764,10211,16275,13356,4663,3372,5223,3077,859,37.4,31121,13111,6434,2.71,3.07,32196,31121,1075,73,26233,4888
A,Henrico County,262300,122922,139378,17932,18812,17908,15223,15380,41138,45028,37178,12038,9062,16212,12050,4339,36,108121,37410,22320,2.39,2.97,112570,108121,4449,454,71089,37032
A,Henry County,57930,28238,29692,3208,3519,3979,3519,3042,7675,9149,8252,3744,3151,5056,2825,811,39.3,23910,7819,6358,2.4,2.87,25921,23910,2011,150,18379,5531
A,Highland County,2536,1254,1282,94,139,168,135,71,218,403,420,186,185,265,207,45,46,1131,298,394,2.24,2.74,1822,1131,691,551,948,183
A,Isle of Wight County,29728,14538,15190,1790,2131,2313,1925,1347,3289,5515,4552,1787,1441,2139,1160,339,38.9,11319,4330,2676,2.61,2.99,12066,11319,747,113,9150,2169
A,James City County,48102,23294,24808,2709,3169,3376,2838,2211,5273,7866,7043,2931,2589,4591,2628,878,40.8,19003,6248,5345,2.47,2.86,20772,19003,1769,343,14640,4363
A,King and Queen County,6630,3233,3397,355,416,461,410,331,708,1072,1005,457,327,585,385,118,40.9,2673,875,836,2.48,2.94,3010,2673,337,89,2204,469
A,King George County,16803,8443,8360,1272,1313,1333,1181,949,2317,3011,2304,871,642,885,541,184,35.1,6091,2523,1123,2.7,3.12,6820,6091,729,230,4376,1715
A,King William County,13146,6470,6676,912,948,974,854,526,1866,2274,1959,783,517,863,504,166,37,4846,1967,1106,2.69,3.06,5189,4846,343,85,4118,728
A,Lancaster County,11567,5374,6193,481,587,691,644,363,828,1444,1571,828,835,1632,1214,449,49.8,5004,1221,2106,2.23,2.71,6498,5004,1494,943,4155,849
A,Lee County,23589,11444,12145,1374,1438,1625,1487,1333,2975,3503,3522,1429,1262,1923,1286,432,39.7,9706,3155,2753,2.41,2.91,11086,9706,1380,134,7223,2483
A,Loudoun County,169599,83837,85762,16461,15269,12538,9031,6908,29920,36086,22232,7227,4389,5402,3143,993,33.6,59900,27037,6897,2.82,3.24,62160,59900,2260,355,47539,12361
A,Louisa County,25627,12611,13016,1524,1782,1860,1621,1159,3096,4560,3904,1518,1288,1932,1055,328,38.8,9945,3577,2451,2.56,2.97,11855,9945,1910,1226,8110,1835
A,Lunenburg County,13146,6997,6149,644,728,900,857,722,1577,2120,1985,732,671,1208,803,199,40.5,4998,1576,1668,2.39,2.91,5736,4998,738,165,3884,1114
A,Madison County,12520,6099,6421,720,813,907,867,569,1389,2065,1914,765,628,1029,596,258,40,4739,1633,1292,2.6,3.03,5239,4739,500,250,3641,1098
A,Mathews County,9207,4441,4766,420,489,555,529,316,848,1282,1397,721,657,1050,679,264,46.2,3932,1044,1405,2.32,2.75,5333,3932,1401,891,3331,601
A,Mecklenburg County,32380,15972,16408,1737,1913,2096,1905,1654,3909,4965,4595,1981,1849,3310,1935,531,40.9,12951,3977,4203,2.38,2.87,17403,12951,4452,2715,9641,3310
A,Middlesex County,9932,4773,5159,375,525,657,527,334,890,1385,1515,828,666,1242,740,248,46.8,4253,1094,1583,2.27,2.73,6362,4253,2109,1626,3533,720
A,Montgomery County,83629,43806,39823,3980,3952,4000,10571,17989,11722,9728,8737,3215,2530,3931,2408,866,25.9,30997,8392,5030,2.4,2.87,32527,30997,1530,160,17090,13907
A,Nelson County,14445,7031,7414,759,805,968,916,605,1475,2217,2474,980,826,1410,777,233,42.8,5887,1787,1730,2.42,2.88,8554,5887,2667,2115,4759,1128
A,New Kent County,13462,6819,6643,759,927,1055,910,506,1666,2646,2323,815,587,783,387,98,38.4,4925,1893,951,2.65,2.97,5203,4925,278,53,4369,556
A,Northampton County,13093,6126,6967,724,806,948,883,620,1215,1881,1804,741,700,1502,917,352,42.4,5321,1663,2010,2.39,2.94,6547,5321,1226,488,3649,1672
A,Northumberland County,12259,5848,6411,527,629,693,642,386,949,1532,1611,1047,1036,1841,1082,284,50.1,5470,1285,2304,2.24,2.7,8057,5470,2587,1861,4783,687
A,Nottoway County,15725,8113,7612,878,977,1109,960,941,2098,2505,2027,812,722,1387,956,353,38.6,5664,1972,1817,2.48,3,6373,5664,709,102,4016,1648
A,Orange County,25881,12524,13357,1552,1621,1756,1570,1134,3015,4169,3559,1555,1506,2564,1461,419,40.4,10150,3367,3055,2.5,2.9,11354,10150,1204,484,7822,2328
A,Page County,23177,11366,11811,1286,1515,1563,1520,1229,2991,3573,3251,1441,1164,2017,1236,391,39,9305,3090,2601,2.46,2.91,10557,9305,1252,651,6872,2433
A,Patrick County,19407,9551,9856,1114,1179,1178,1148,975,2513,2922,2768,1282,1132,1720,1092,384,40.5,8141,2516,2254,2.36,2.81,9823,8141,1682,730,6535,1606
A,Pittsylvania County,61745,30146,31599,3514,3812,4231,4143,2977,7443,10322,9492,3848,3104,5000,2990,869,39.6,24684,8472,6513,2.49,2.93,28011,24684,3327,998,19767,4917
A,Powhatan County,22377,12313,10064,1309,1537,1506,1584,1063,3396,4370,3525,1327,877,1155,583,145,36.8,7258,2977,1351,2.74,3.03,7509,7258,251,36,6448,810
A,Prince Edward County,19720,9641,10079,983,1108,1205,2601,2724,1996,2442,2263,849,754,1352,984,459,31.5,6561,2221,1909,2.43,2.99,7527,6561,966,205,4489,2072
A,Prince George County,33047,17821,15226,1980,2370,2506,3026,2904,5361,5639,4301,1451,1109,1492,740,168,32.1,10159,4639,1779,2.76,3.11,10726,10159,567,36,7418,2741
A,Prince William County,280813,140067,140746,24007,24461,23582,20433,17746,45311,53512,38377,12227,7684,8490,3856,1127,31.9,94570,45000,9981,2.94,3.32,98052,94570,3482,226,67787,26783
A,Pulaski County,35127,17334,17793,1937,2032,2059,1922,1849,4957,5293,5584,2297,1864,2887,1875,571,40.3,14643,4419,3826,2.32,2.8,16325,14643,1682,729,10794,3849
A,Rappahannock County,6983,3471,3512,356,421,518,403,252,699,1148,1286,507,430,567,309,87,42.6,2788,856,709,2.5,2.94,3303,2788,515,309,2097,691
A,Richmond County,8809,4939,3870,360,425,490,518,532,1238,1567,1232,462,428,757,545,255,40.3,2937,909,963,2.4,2.93,3512,2937,575,280,2273,664
A,Roanoke County,85778,40535,45243,4553,5581,5911,5448,3698,9782,13843,14240,5014,4063,7184,4757,1704,40.9,34686,11358,8968,2.41,2.88,36121,34686,1435,161,26783,7903
A,Rockbridge County,20808,10427,10381,1123,1231,1387,1329,1196,2421,3229,3151,1274,1208,1942,1027,290,40.4,8486,2718,2367,2.43,2.84,9550,8486,1064,382,6590,1896
A,Rockingham County,67725,33340,34385,4246,4691,4947,4772,3915,8556,11017,9601,3526,3023,5051,3252,1128,37.5,25355,9121,6441,2.61,3.02,27328,25355,1973,818,19787,5568
A,Russell County,30308,15353,14955,1626,1755,1803,1974,1871,4416,4950,4578,1789,1505,2311,1284,446,38.7,11789,4025,2916,2.44,2.87,13191,11789,1402,68,9557,2232
A,Scott County,23403,11297,12106,1203,1354,1430,1381,1215,2945,3433,3420,1516,1346,2239,1397,524,41.4,9795,2955,2943,2.35,2.82,11355,9795,1560,291,7657,2138
A,Shenandoah County,35075,17075,18000,1948,2250,2311,2064,1563,4239,5427,5018,2236,1936,3302,2119,662,40.9,14296,4423,4218,2.42,2.86,16709,14296,2413,1462,10462,3834
A,Smyth County,33081,16008,17073,1769,2100,2057,2018,1842,4315,4983,4788,1972,1833,2953,1848,603,40,13493,4353,3845,2.37,2.83,15111,13493,1618,469,9995,3498
A,Southampton County,17482,9226,8256,899,1104,1243,1179,1092,2128,2971,2470,984,921,1298,946,247,38.6,6279,2233,1787,2.53,3.02,7058,6279,779,98,4663,1616
A,Spotsylvania County,90395,44532,45863,6879,7894,8008,6350,4603,12552,16510,12846,4184,3043,4342,2443,741,34.3,31308,14393,5266,2.87,3.22,33329,31308,2021,564,25735,5573
A,Stafford County,92446,46486,45960,7172,8559,8632,6974,5027,12853,18272,12958,4067,2458,3256,1670,548,33.1,30187,15222,3846,3.01,3.32,31405,30187,1218,121,24322,5865
A,Surry County,6829,3304,3525,385,475,561,469,323,700,1198,976,444,337,529,341,91,39.4,2619,963,725,2.61,3.09,3294,2619,675,369,2022,597
A,Sussex County,12504,7185,5319,576,713,731,684,874,2054,2242,1802,604,549,889,575,211,37.6,4126,1378,1234,2.41,2.94,4653,4126,527,85,2869,1257
A,Tazewell County,44598,21369,23229,2359,2678,2733,2975,2545,5283,6854,7222,2710,2317,3819,2364,739,40.7,18277,5838,5097,2.4,2.85,20390,18277,2113,209,14129,4148
A,Warren County,31584,15530,16054,2100,2356,2363,2013,1637,4079,5593,4453,1727,1370,2134,1360,399,37.1,12087,4387,2780,2.57,3.04,13299,12087,1212,534,8967,3120
A,Washington County,51103,24789,26314,2592,2965,3134,3328,3052,6339,8124,7758,3215,2762,4457,2555,822,40.3,21056,6506,5574,2.36,2.84,22985,21056,1929,502,16255,4801
A,Westmoreland County,16718,8023,8695,866,1052,1226,1051,706,1633,2369,2407,1167,1068,1779,1082,312,42.8,6846,2079,2339,2.43,2.91,9286,6846,2440,1676,5423,1423
A,Wise County,40123,19543,20580,2313,2557,2566,3171,2731,5236,6012,5986,2131,1832,3034,1949,605,37.8,16013,5488,4160,2.44,2.91,17792,16013,1779,95,12057,3956
A,Wythe County,27599,13177,14422,1507,1665,1745,1729,1485,3821,4145,4076,1667,1396,2389,1435,539,39.4,11511,3658,3076,2.36,2.83,12744,11511,1233,270,8903,2608
A,York County,56297,27650,28647,3570,4705,5169,4220,2482,6430,10827,8488,3066,2204,3157,1588,391,36.5,20000,8983,3605,2.78,3.15,20701,20000,701,79,15157,4843
F,Alexandria city,128283,61974,66309,7962,5953,4722,4739,9919,32571,23186,17641,6117,3868,5695,4204,1706,34.4,61889,12673,8553,2.04,2.87,64251,61889,2362,523,24745,37144
F,Bedford city,6299,2995,3304,354,408,378,363,316,777,975,753,259,294,612,566,244,40.9,2519,769,837,2.26,2.87,2702,2519,183,17,1519,1000
F,Bristol city,17367,7825,9542,929,982,1033,1008,1067,2167,2384,2330,976,924,1775,1333,459,41.3,7678,2110,2665,2.18,2.78,8469,7678,791,37,4997,2681
F,Buena Vista city,6349,2944,3405,392,391,404,493,420,825,827,872,354,337,542,352,140,37.9,2547,847,747,2.38,2.87,2716,2547,169,7,1800,747
F,Charlottesville city,45049,21021,24028,1981,1920,1882,6053,10207,6566,5039,4210,1433,1210,2307,1643,598,25.6,16851,3879,3151,2.27,2.85,17591,16851,740,71,6882,9969
F,Chesapeake city,199184,96728,102456,14272,16138,17121,14931,11186,26807,37602,27506,8955,6822,10227,6086,1531,34.7,69900,31693,12620,2.79,3.17,72672,69900,2772,190,52335,17565
F,Clifton Forge city,4289,1892,2397,227,251,262,263,188,474,615,525,235,234,453,387,175,42.9,1841,541,666,2.22,2.8,2069,1841,228,6,1153,688
F,Colonial Heights city,16897,7901,8996,895,1053,1189,1073,1014,2029,2498,2252,901,849,1624,1176,344,39.9,7027,2250,2161,2.37,2.88,7340,7027,313,21,4871,2156
F,Covington city,6303,3013,3290,395,389,355,352,375,818,837,818,389,301,623,462,189,40.5,2835,791,966,2.22,2.83,3195,2835,360,15,1977,858
F,Danville city,48411,22024,26387,2910,3114,3300,3141,2681,5563,6772,6687,2504,2237,4702,3584,1216,40.5,20607,6301,6792,2.27,2.89,23108,20607,2501,83,11975,8632
F,Emporia city,5665,2576,3089,351,403,436,387,305,646,803,643,278,245,503,455,210,38.8,2226,758,753,2.43,3.05,2412,2226,186,11,1162,1064
F,Fairfax city,21498,10484,11014,1289,1214,1185,1165,1531,3586,3655,3049,1181,890,1455,950,348,37,8035,2449,1751,2.61,3.07,8204,8035,169,30,5550,2485
F,Falls Church city,10377,5049,5328,571,673,722,608,388,1383,1849,1971,581,369,530,527,205,39.7,4471,1410,941,2.31,3.01,4725,4471,254,90,2708,1763
F,Franklin city,8346,3689,4657,424,613,665,613,424,869,1207,1147,455,393,718,553,265,39.9,3384,1168,991,2.39,2.93,3767,3384,383,25,1818,1566
F,Fredericksburg city,19279,8677,10602,1127,943,867,2104,2982,2856,2385,2138,791,616,1222,926,322,30.3,8102,1956,1918,2.09,2.81,8888,8102,786,43,2882,5220
F,Galax city,6837,3250,3587,439,440,430,418,387,875,928,900,404,306,670,459,181,39.8,2950,892,897,2.27,2.9,3217,2950,267,30,1954,996
F,Hampton city,146437,72579,73858,9242,10073,10309,11242,13013,21662,25880,18133,6388,5352,8503,5305,1335,34,53887,19817,11038,2.49,3.02,57311,53887,3424,285,31570,22317
F,Harrisonburg city,40468,19171,21297,1905,1715,1612,6449,11108,4584,3992,3251,1175,910,1740,1456,571,22.6,13133,3320,2373,2.53,3,13689,13133,556,37,5125,8008
F,Hopewell city,22354,10447,11907,1667,1777,1588,1509,1466,3162,3235,2659,1134,891,1747,1136,383,35,9055,3304,2331,2.43,2.94,9749,9055,694,16,5067,3988
F,Lexington city,6867,3791,3076,205,195,213,1302,1683,528,470,620,268,257,529,419,178,23.3,2232,447,751,2.06,2.76,2376,2232,144,13,1225,1007
F,Lynchburg city,65269,29841,35428,3817,4102,4192,5796,6644,7972,8530,8094,2923,2554,4888,3989,1768,35.1,25477,7868,7167,2.3,2.92,27640,25477,2163,134,14914,10563
F,Manassas city,35135,17868,17267,3020,3053,2776,2509,2486,6116,6464,4589,1348,872,1086,599,217,31.3,11757,5348,1325,2.92,3.39,12114,11757,357,29,8203,3554
F,Manassas Park city,10290,5242,5048,1024,906,810,691,660,2130,1994,1049,324,260,311,108,23,30.3,3254,1633,357,3.16,3.47,3365,3254,111,4,2560,694
F,Martinsville city,15416,6966,8450,867,969,1020,940,762,1778,2332,2020,789,760,1492,1197,490,40.8,6498,2001,2136,2.27,2.89,7249,6498,751,22,3914,2584
F,Newport News city,180150,87178,92972,14228,14404,13457,13136,14930,28448,29485,20773,7375,5761,9758,6515,1880,32,69686,27420,13222,2.5,3.04,74117,69686,4431,226,36513,33173
F,Norfolk city,234403,119830,114573,16546,16508,15072,18926,31983,36620,33569,25010,8143,6494,12979,9693,2860,29.6,86210,30086,18877,2.45,3.07,94416,86210,8206,282,39238,46972
F,Norton city,3904,1757,2147,201,261,239,250,299,509,557,580,212,200,316,204,76,39,1730,516,456,2.23,2.88,1946,1730,216,1,967,763
F,Petersburg city,33740,15426,18314,2165,2433,2522,2226,2151,4393,4883,4460,1759,1501,2692,1897,658,36.9,13799,4667,3779,2.38,2.98,15955,13799,2156,23,7107,6692
F,Poquoson city,11566,5789,5777,587,863,1051,876,463,1041,2052,1953,778,588,766,392,156,39.5,4166,1743,907,2.75,3.08,4300,4166,134,23,3503,663
F,Portsmouth city,100565,48583,51982,7171,7294,7167,7337,8012,14105,15180,12369,4315,3761,6879,5422,1553,34.5,38170,13987,10167,2.51,3.05,41605,38170,3435,121,22356,15814
F,Radford city,15859,7215,8644,561,547,592,2719,4605,1710,1392,1304,531,433,770,538,157,22.8,5809,1200,1099,2.25,2.78,6137,5809,328,30,2588,3221
F,Richmond city,197790,92068,105722,12376,12765,11713,13870,18386,32871,29841,24985,8208,6646,12843,9764,3522,33.9,84549,23459,19421,2.21,2.95,92282,84549,7733,249,39008,45541
F,Roanoke city,94911,44501,50410,6200,6381,5802,5072,5746,14400,14548,13098,4555,3549,7366,5996,2198,37.6,42003,12211,11180,2.2,2.86,45257,42003,3254,175,23637,18366
F,Salem city,24747,11677,13070,1212,1458,1546,1979,1857,2909,3708,3456,1328,1146,2182,1478,488,39.2,9954,3024,2811,2.32,2.84,10403,9954,449,41,6730,3224
F,Staunton city,23853,11237,12616,1241,1285,1331,1652,1661,3104,3531,3345,1282,1121,2113,1601,586,39.8,9676,2663,2938,2.19,2.81,10427,9676,751,38,5939,3737
F,Suffolk city,63677,30410,33267,4618,5076,5223,4269,3049,8514,11313,8505,3283,2559,3988,2496,784,36,23283,9713,5274,2.69,3.09,24704,23283,1421,70,16815,6468
F,Virginia Beach city,425257,210524,214733,30616,33523,33749,30239,31313,69842,75897,53798,17465,12882,20735,11649,3549,32.7,154455,64971,25377,2.7,3.14,162277,154455,7822,2344,101308,53147
F,Waynesboro city,19520,9140,10380,1282,1351,1306,1148,1113,2510,2840,2515,1081,933,1737,1297,407,38.9,8332,2697,2365,2.31,2.85,8863,8332,531,21,5103,3229
F,Williamsburg city,11998,5382,6616,326,304,307,2235,3500,1158,967,957,429,411,713,520,171,22.6,3619,665,952,2.07,2.66,3880,3619,261,65,1602,2017
F,Winchester city,23585,11434,12151,1432,1457,1381,1783,2156,3514,3510,3009,1037,875,1825,1235,371,35.2,10001,2868,2533,2.28,2.93,10587,10001,586,57,4567,5434
A,Abingdon town,7780,3481,4299,381,381,419,427,455,1004,1128,1122,449,414,769,562,269,42.4,3522,891,1050,2.08,2.72,3788,3522,266,45,2045,1477
A,Accomac town,547,311,236,29,14,21,32,45,81,87,76,28,28,48,47,11,40.1,199,48,83,2.13,2.71,235,199,36,7,154,45
S,Adwolf CDP,1457,727,730,70,91,86,86,81,168,255,258,92,73,125,63,9,41.3,587,189,144,2.48,2.79,617,587,30,3,478,109
A,Alberta town,306,142,164,18,28,22,18,12,35,48,44,15,15,33,13,5,39.3,128,39,41,2.39,2.93,158,128,30,5,83,45
A,Alexandria city,128283,61974,66309,7962,5953,4722,4739,9919,32571,23186,17641,6117,3868,5695,4204,1706,34.4,61889,12673,8553,2.04,2.87,64251,61889,2362,523,24745,37144
A,Altavista town,3425,1497,1928,185,211,235,218,151,374,438,480,213,173,358,273,116,42.6,1502,454,522,2.23,2.86,1650,1502,148,2,996,506
A,Amherst town,2251,1032,1219,129,135,151,115,94,238,311,281,132,117,216,190,142,43.4,940,283,333,2.18,2.84,1000,940,60,4,611,329
S,Annandale CDP,54994,26816,28178,3550,3515,3449,2965,3003,8260,9533,8704,3125,2420,3737,2206,527,37.9,19927,6893,4477,2.73,3.18,20243,19927,316,39,13438,6489
A,Appalachia town,1839,854,985,129,142,122,121,129,243,235,249,91,85,135,128,30,37,790,258,245,2.33,2.95,891,790,101,6,486,304
A,Appomattox town,1761,795,966,136,110,114,111,102,213,270,218,78,71,150,127,61,38.7,716,244,229,2.35,2.92,767,716,51,4,469,247
S,Aquia Harbour CDP,7856,3951,3905,460,632,760,727,341,758,1550,1555,460,217,250,123,23,36.9,2569,1244,292,3.06,3.24,2622,2569,53,6,2253,316
S,Arlington CDP,189453,95443,94010,10397,8741,7635,7640,16535,47675,32664,25841,8816,5747,8330,6914,2518,34,86352,18038,13296,2.15,2.96,90426,86352,4074,1526,37370,48982
A,Ashland town,6619,3095,3524,327,367,401,803,891,709,942,802,267,187,413,366,144,32.5,2282,793,554,2.38,2.93,2445,2282,163,6,1368,914
S,Atkins CDP,1138,540,598,70,66,73,67,73,159,164,169,65,66,91,61,14,38.5,494,150,128,2.3,2.81,571,494,77,4,370,124
S,Bailey's Crossroads CDP,23166,11938,11228,1812,1538,1247,1250,1928,4626,3961,2744,966,699,1002,977,416,33.1,8547,2803,1831,2.7,3.4,8813,8547,266,48,3541,5006
S,Bassett CDP,1338,641,697,55,49,94,68,70,157,165,155,102,78,156,120,69,45.5,530,151,210,2.33,2.93,601,530,71,3,393,137
S,Basye-Bryce Mountain CDP,986,501,485,44,57,41,44,28,79,108,158,103,97,160,55,12,51.1,445,87,161,2.22,2.59,1151,445,706,661,382,63
A,Bedford city,6299,2995,3304,354,408,378,363,316,777,975,753,259,294,612,566,244,40.9,2519,769,837,2.26,2.87,2702,2519,183,17,1519,1000
A,Belle Haven town,480,212,268,20,25,23,41,18,48,71,67,21,43,55,32,16,44,220,63,80,2.11,2.62,248,220,28,6,161,59
S,Belle Haven CDP,6269,2922,3347,344,292,302,211,189,1043,1151,1097,412,296,454,377,101,41.4,3116,645,694,2.01,2.77,3220,3116,104,27,2214,902
S,Bellwood CDP,5974,2963,3011,481,547,442,385,354,919,984,735,341,235,328,182,41,33.6,2323,945,428,2.57,3.05,2448,2323,125,5,1409,914
S,Bensley CDP,5435,2702,2733,383,402,380,397,422,912,855,697,246,240,297,174,30,32.9,2252,817,391,2.41,2.97,2368,2252,116,5,1017,1235
A,Berryville town,2963,1328,1635,168,229,187,144,124,313,495,351,142,143,292,253,122,41.3,1239,387,431,2.28,2.9,1312,1239,73,6,739,500
A,Big Stone Gap town,4856,2258,2598,322,309,283,343,303,576,632,745,255,221,397,317,153,39.8,1995,654,575,2.34,2.92,2197,1995,202,3,1290,705
A,Blacksburg town,39573,22140,17433,1157,993,1042,7892,15436,4864,2608,2258,730,643,1018,693,239,21.9,13162,2240,1281,2.37,2.79,13732,13162,570,51,4003,9159
A,Blackstone town,3675,1650,2025,228,243,269,238,189,436,496,432,202,161,342,289,150,40,1430,499,475,2.41,3.06,1581,1430,151,24,883,547
A,Bloxom town,395,196,199,22,19,23,34,36,49,47,54,32,21,24,30,4,37.8,160,47,43,2.47,2.94,175,160,15,4,119,41
A,Bluefield town,5078,2350,2728,209,236,298,369,317,465,663,799,309,280,569,398,166,44.8,2134,516,779,2.23,2.77,2349,2134,215,17,1678,456
S,Blue Ridge CDP,3188,1536,1652,178,206,258,216,93,335,608,608,198,152,227,89,20,40.2,1181,447,233,2.7,2.99,1219,1181,38,3,1078,103
S,Bon Air CDP,16213,7822,8391,819,1082,1277,1544,517,1650,2619,2846,952,686,1249,753,219,40,6308,2169,1531,2.47,2.97,6502,6308,194,10,5236,1072
A,Boones Mill town,285,136,149,7,21,23,13,20,51,43,46,5,13,26,15,2,36.2,131,38,33,2.18,2.82,138,131,7,1,87,44
A,Bowling Green town,936,384,552,49,46,47,33,38,102,112,105,59,39,91,124,91,48.5,387,95,149,2.1,2.81,425,387,38,2,223,164
A,Boyce town,426,220,206,19,32,38,27,16,61,73,61,27,16,36,14,6,37.4,159,54,44,2.68,3.19,168,159,9,1,112,47
A,Boydton town,454,249,205,17,21,20,29,44,54,75,67,16,18,47,36,10,39.5,134,39,58,2.4,2.88,165,134,31,4,106,28
A,Boykins town,620,292,328,41,41,31,42,19,55,96,71,45,41,70,54,14,43,255,76,104,2.43,2.96,287,255,32,1,200,55
A,Branchville town,123,53,70,3,10,10,10,4,9,20,17,5,7,15,11,2,44.1,50,18,23,2.46,2.97,56,50,6,1,39,11
A,Bridgewater town,5203,2341,2862,245,262,310,644,659,543,649,558,199,158,333,401,242,34,1788,551,575,2.31,2.85,1850,1788,62,11,1124,664
A,Bristol city,17367,7825,9542,929,982,1033,1008,1067,2167,2384,2330,976,924,1775,1333,459,41.3,7678,2110,2665,2.18,2.78,8469,7678,791,37,4997,2681
A,Broadway town,2192,1039,1153,159,138,149,135,137,301,366,295,118,82,177,116,19,36.9,882,305,222,2.42,2.91,976,882,94,1,576,306
A,Brodnax town,317,147,170,21,24,23,27,8,41,47,40,14,13,43,14,2,39.3,122,41,46,2.6,3.29,139,122,17,4,81,41
A,Brookneal town,1259,558,701,75,85,101,78,45,134,173,172,46,58,135,104,53,41.8,509,170,187,2.36,2.98,580,509,71,5,326,183
A,Buchanan town,1233,579,654,63,70,77,65,60,178,182,161,71,63,139,84,20,40.6,540,153,190,2.28,2.79,579,540,39,6,424,116
A,Buena Vista city,6349,2944,3405,392,391,404,493,420,825,827,872,354,337,542,352,140,37.9,2547,847,747,2.38,2.87,2716,2547,169,7,1800,747
S,Bull Run CDP,11337,5585,5752,1225,884,598,569,1136,3010,1993,965,294,209,245,166,43,29.1,4728,1767,400,2.4,3.03,4948,4728,220,33,1762,2966
S,Burke CDP,57737,28142,29595,3420,4262,5020,4876,2767,6191,10337,11708,3925,2058,1898,881,394,37.6,19215,8830,2290,2.99,3.3,19367,19215,152,22,16006,3209
A,Burkeville town,489,234,255,22,29,35,38,33,50,73,69,21,28,50,26,15,39.8,206,65,70,2.37,2.95,248,206,42,1,147,59
S,Cana CDP,1228,592,636,66,75,90,73,66,186,175,167,79,84,114,42,11,38.3,520,159,128,2.36,2.9,576,520,56,14,436,84
A,Cape Charles town,1134,491,643,76,63,75,60,58,103,146,149,63,71,132,104,34,44.2,536,135,229,2.11,2.91,740,536,204,82,248,288
A,Capron town,167,85,82,8,11,13,12,6,17,34,15,14,10,11,12,4,40.6,72,23,23,2.32,3.04,79,72,7,0,51,21
S,Castlewood CDP,2036,982,1054,97,108,121,143,103,210,325,342,119,104,225,115,24,42.4,872,261,260,2.32,2.76,950,872,78,1,690,182
S,Cave Spring CDP,24941,11800,13141,1281,1564,1702,1461,1207,3068,3897,4196,1432,1193,2172,1455,313,40.9,10997,3199,2809,2.26,2.84,11556,10997,559,74,7656,3341
A,Cedar Bluff town,1085,512,573,76,69,63,67,51,134,157,159,80,61,81,61,26,40.4,475,149,138,2.28,2.84,535,475,60,3,335,140
S,Centreville CDP,48661,24037,24624,4362,4033,3620,2728,3072,10938,10317,5726,1417,859,958,516,115,31.1,17789,7679,1284,2.74,3.27,18176,17789,387,59,11689,6100
S,Chamberlayne CDP,4380,2062,2318,162,210,231,190,133,389,585,765,338,318,605,357,97,48.6,1884,447,746,2.32,2.73,1916,1884,32,2,1787,97
S,Chantilly CDP,41041,20351,20690,3065,3127,2886,2403,2416,7581,8176,6288,1928,1215,1218,551,187,33.8,14840,5931,1388,2.75,3.24,15173,14840,333,102,10956,3884
A,Charlotte Court House town,404,210,194,15,24,25,21,30,54,55,52,29,19,38,28,14,41,148,40,60,2.39,2.9,177,148,29,2,124,24
A,Charlottesville city,45049,21021,24028,1981,1920,1882,6053,10207,6566,5039,4210,1433,1210,2307,1643,598,25.6,16851,3879,3151,2.27,2.85,17591,16851,740,71,6882,9969
A,Chase City town,2457,1093,1364,178,179,187,121,124,279,299,323,107,124,270,208,58,40,1099,338,434,2.24,2.93,1249,1099,150,9,681,418
A,Chatham town,1338,669,669,65,66,82,67,65,175,183,200,88,69,117,120,41,43.2,554,138,208,2.22,2.87,612,554,58,4,393,161
S,Chatmoss CDP,1742,846,896,97,99,132,99,63,132,303,333,158,95,126,74,31,43.1,678,237,164,2.57,2.88,715,678,37,6,620,58
A,Cheriton town,499,221,278,33,33,31,21,14,48,75,70,22,34,66,38,14,44.2,219,60,95,2.28,2.9,239,219,20,5,155,64
A,Chesapeake city,199184,96728,102456,14272,16138,17121,14931,11186,26807,37602,27506,8955,6822,10227,6086,1531,34.7,69900,31693,12620,2.79,3.17,72672,69900,2772,190,52335,17565
S,Chester CDP,17890,8710,9180,1335,1414,1442,1345,928,2423,3189,2741,913,673,943,457,87,35.2,6727,2885,1087,2.66,3.04,6951,6727,224,24,5109,1618
S,Chesterfield Court House CDP,3558,1790,1768,167,220,269,317,263,550,640,468,164,117,146,136,101,34.9,1139,466,149,2.53,3.06,1171,1139,32,5,771,368
A,Chilhowie town,1827,806,1021,75,99,87,78,75,208,234,256,94,95,192,209,125,47.3,708,199,242,2.22,2.76,775,708,67,3,439,269
A,Chincoteague town,4317,2096,2221,179,200,246,223,165,439,627,677,343,316,519,320,63,46.1,2068,495,659,2.08,2.63,3970,2068,1902,1717,1639,429
A,Christiansburg town,16947,8151,8796,1252,1078,1039,1026,991,3044,2597,2318,874,680,1151,679,218,35.2,7093,2357,1518,2.35,2.86,7430,7093,337,17,4747,2346
A,Claremont town,343,165,178,8,17,26,22,15,32,56,67,27,14,36,17,6,44.3,147,40,43,2.33,2.83,240,147,93,64,119,28
A,Clarksville town,1329,580,749,79,70,84,53,57,187,130,172,89,72,169,136,31,45.4,641,159,259,2.07,2.71,753,641,112,27,455,186
S,Claypool Hill CDP,1719,813,906,87,98,93,103,76,221,244,357,126,97,150,59,8,42.4,710,229,155,2.42,2.74,760,710,50,4,603,107
A,Cleveland town,148,75,73,4,5,3,4,7,20,14,16,11,15,26,17,6,55.3,81,11,35,1.83,2.45,113,81,32,0,52,29
A,Clifton town,185,106,79,12,10,14,11,10,23,37,41,14,5,3,5,0,37.3,67,28,6,2.76,3.06,70,67,3,0,58,9
A,Clifton Forge city,4289,1892,2397,227,251,262,263,188,474,615,525,235,234,453,387,175,42.9,1841,541,666,2.22,2.8,2069,1841,228,6,1153,688
A,Clinchco town,424,196,228,27,26,32,20,25,62,52,58,28,23,31,34,6,39.4,189,66,58,2.24,3,226,189,37,4,133,56
A,Clinchport town,77,42,35,3,6,7,5,4,15,11,7,3,6,8,2,0,34.5,31,12,8,2.48,3.16,38,31,7,2,24,7
A,Clintwood town,1549,709,840,85,59,76,62,101,177,182,216,114,100,168,146,63,46.5,672,167,237,2.1,2.65,756,672,84,9,465,207
S,Cloverdale CDP,2986,1460,1526,183,250,248,209,121,266,582,508,178,128,197,96,20,39,1158,456,226,2.58,3.05,1204,1158,46,2,954,204
A,Coeburn town,1996,964,1032,107,119,124,155,132,269,301,297,94,87,169,112,30,38.6,810,272,229,2.44,2.92,923,810,113,0,563,247
S,Collinsville CDP,7777,3690,4087,476,464,474,444,469,1129,1179,1008,432,367,686,495,154,38.3,3466,1036,942,2.23,2.77,3758,3466,292,6,2159,1307
A,Colonial Beach town,3228,1461,1767,181,192,204,201,136,315,433,442,212,186,379,255,92,43.8,1437,392,524,2.2,2.77,2030,1437,593,415,933,504
A,Colonial Heights city,16897,7901,8996,895,1053,1189,1073,1014,2029,2498,2252,901,849,1624,1176,344,39.9,7027,2250,2161,2.37,2.88,7340,7027,313,21,4871,2156
A,Columbia town,49,20,29,2,0,6,4,2,3,7,12,7,3,1,2,0,47.5,18,7,3,2.72,3.23,22,18,4,0,13,5
A,Courtland town,1270,615,655,68,91,84,78,69,165,178,171,68,55,83,106,54,38.5,460,166,138,2.35,2.96,498,460,38,1,262,198
A,Covington city,6303,3013,3290,395,389,355,352,375,818,837,818,389,301,623,462,189,40.5,2835,791,966,2.22,2.83,3195,2835,360,15,1977,858
A,Craigsville town,979,445,534,60,64,67,77,54,127,163,135,40,37,84,55,16,37.6,413,143,121,2.37,2.98,474,413,61,8,263,150
A,Crewe town,2378,1106,1272,178,192,209,158,135,288,336,266,100,86,220,164,46,35.8,971,370,326,2.45,2.98,1074,971,103,4,616,355
S,Crimora CDP,1796,879,917,95,120,151,113,100,230,315,250,103,108,145,52,14,37.8,724,265,167,2.48,2.92,761,724,37,5,673,51
S,Crozet CDP,2820,1305,1515,196,222,219,179,75,327,487,402,184,127,228,136,38,39.1,995,413,237,2.68,3.07,1041,995,46,3,849,146
A,Culpeper town,9664,4520,5144,730,763,624,648,681,1397,1535,1134,363,337,714,553,185,34.9,3933,1403,1002,2.39,2.97,4139,3933,206,30,1824,2109
S,Dahlgren CDP,997,490,507,56,64,75,66,54,146,159,114,44,50,84,65,20,37.3,456,130,125,2.19,2.85,510,456,54,6,254,202
S,Dale City CDP,55971,27662,28309,4496,5294,5422,4651,3153,8529,10980,7417,2415,1506,1456,532,120,31.4,17623,9398,1660,3.17,3.48,18171,17623,548,18,13712,3911
S,Daleville CDP,1454,730,724,80,103,102,71,41,128,231,254,130,81,150,70,13,44,562,185,161,2.59,2.85,573,562,11,2,545,17
A,Damascus town,981,454,527,41,55,41,56,44,108,141,136,84,58,100,94,23,45.3,484,107,178,2.03,2.72,543,484,59,17,295,189
A,Danville city,48411,22024,26387,2910,3114,3300,3141,2681,5563,6772,6687,2504,2237,4702,3584,1216,40.5,20607,6301,6792,2.27,2.89,23108,20607,2501,83,11975,8632
A,Dayton town,1344,666,678,92,92,94,78,59,202,249,147,60,61,118,77,15,37.2,542,182,147,2.48,2.97,565,542,23,1,340,202
A,Dendron town,297,131,166,24,21,22,12,21,40,28,45,13,13,23,25,10,38.3,106,42,43,2.8,3.4,121,106,15,4,91,15
A,Dillwyn town,447,185,262,26,20,24,28,13,47,49,58,26,24,43,52,37,48.3,176,57,63,2.16,2.63,200,176,24,0,88,88
S,Dooms CDP,1282,624,658,53,87,85,70,41,144,235,201,91,75,128,57,15,42,522,165,146,2.4,2.77,553,522,31,0,456,66
A,Drakes Branch town,504,237,267,20,30,31,30,25,56,67,68,41,34,52,42,8,44,231,57,75,2.18,2.81,262,231,31,1,152,79
S,Dryden CDP,1253,595,658,86,87,82,61,75,178,165,191,74,54,87,71,42,39.1,453,166,103,2.49,2.96,507,453,54,5,305,148
A,Dublin town,2288,1192,1096,147,122,90,128,223,451,329,292,120,84,157,123,22,34.5,911,260,234,2.13,2.79,969,911,58,5,429,482
A,Duffield town,62,28,34,3,5,3,2,3,8,8,9,5,8,4,3,1,44.5,25,8,6,2.48,2.85,30,25,5,1,22,3
S,Dumbarton CDP,6674,2938,3736,388,363,285,343,642,1314,915,631,220,221,542,618,192,35,3515,790,1099,1.89,2.72,3782,3515,267,11,918,2597
A,Dumfries town,4937,2454,2483,504,493,467,408,333,716,941,546,180,118,163,51,17,29,1573,822,182,3.13,3.51,1699,1573,126,1,1004,569
A,Dungannon town,317,150,167,18,23,20,27,19,37,49,50,12,18,25,14,5,39.1,132,50,38,2.4,2.96,149,132,17,2,93,39
S,Dunn Loring CDP,7861,3986,3875,613,514,497,393,362,1200,1477,1222,390,341,554,232,66,36.9,2668,1014,546,2.9,3.18,2711,2668,43,8,2172,496
S,East Highland Park CDP,12488,5722,6766,721,948,956,814,664,1601,2090,1869,726,550,844,532,173,37.4,4960,1801,1071,2.48,3.02,5226,4960,266,26,3563,1397
A,Eastville town,203,114,89,6,5,15,15,25,15,38,36,2,9,24,8,5,40.8,69,21,28,2.2,2.84,75,69,6,0,50,19
A,Edinburg town,813,391,422,40,43,43,32,57,121,103,108,55,37,84,58,32,41.4,385,87,130,2.09,2.71,425,385,40,4,201,184
A,Elkton town,2042,964,1078,121,130,138,136,130,296,328,247,111,100,161,108,36,37,862,272,215,2.34,2.86,919,862,57,2,492,370
S,Elliston-Lafayette CDP,1241,596,645,88,106,86,86,87,173,218,144,64,55,65,52,17,34.6,489,192,103,2.53,2.97,533,489,44,5,380,109
S,Emory-Meadow View CDP,2266,1110,1156,99,86,92,397,415,180,266,268,117,79,132,95,40,27.2,652,220,178,2.47,2.91,712,652,60,10,503,149
A,Emporia city,5665,2576,3089,351,403,436,387,305,646,803,643,278,245,503,455,210,38.8,2226,758,753,2.43,3.05,2412,2226,186,11,1162,1064
S,Ettrick CDP,5627,2476,3151,240,276,284,1312,1134,558,600,468,137,127,269,179,43,21.7,1517,572,364,2.51,3.03,1673,1517,156,2,970,547
S,Ewing CDP,436,204,232,22,32,36,25,26,50,58,67,14,34,40,24,8,39.6,183,63,55,2.38,2.91,216,183,33,5,134,49
A,Exmore town,1136,534,602,71,67,92,86,60,142,138,145,65,54,114,60,42,38.6,475,157,161,2.39,2.95,524,475,49,1,302,173
A,Fairfax city,21498,10484,11014,1289,1214,1185,1165,1531,3586,3655,3049,1181,890,1455,950,348,37,8035,2449,1751,2.61,3.07,8204,8035,169,30,5550,2485
S,Fairlawn CDP,2211,1042,1169,119,128,109,90,139,334,299,318,132,103,208,156,76,40.8,995,253,275,2.16,2.68,1065,995,70,4,703,292
S,Fairview Beach CDP,230,119,111,10,8,7,13,17,23,31,42,18,11,27,20,3,46.3,112,22,33,2.05,2.56,222,112,110,90,87,25
A,Falls Church city,10377,5049,5328,571,673,722,608,388,1383,1849,1971,581,369,530,527,205,39.7,4471,1410,941,2.31,3.01,4725,4471,254,90,2708,1763
S,Falmouth CDP,3624,1739,1885,213,274,276,268,181,428,574,515,240,172,227,188,68,38.1,1323,512,292,2.68,3.03,1412,1323,89,4,926,397
S,Fancy Gap CDP,260,123,137,16,22,9,15,8,39,28,39,24,16,30,13,1,42.5,110,33,31,2.36,2.79,156,110,46,33,89,21
A,Farmville town,6845,2759,4086,299,293,258,1393,1547,590,538,550,204,175,380,391,227,22.4,2050,570,632,2.15,2.84,2294,2050,244,22,991,1059
S,Ferrum CDP,1313,722,591,42,54,57,352,375,106,120,96,27,24,33,21,6,20.9,285,99,44,2.38,3.07,307,285,22,2,181,104
S,Fieldale CDP,929,457,472,37,60,61,48,28,110,127,117,57,61,113,87,23,44.5,420,107,164,2.21,2.78,473,420,53,3,358,62
A,Fincastle town,359,194,165,15,17,24,29,26,50,66,54,21,12,24,16,5,39.4,129,40,34,2.39,3.04,142,129,13,3,98,31
S,Fishersville CDP,4998,2381,2617,321,336,272,262,190,561,822,720,332,280,407,330,165,41.6,1826,642,482,2.51,2.85,1931,1826,105,3,1546,280
A,Floyd town,432,179,253,17,25,26,17,15,48,50,55,25,21,59,56,18,48.4,238,49,108,1.82,2.57,264,238,26,2,131,107
S,Forest CDP,8006,3937,4069,518,598,642,528,353,1036,1484,1323,449,311,477,238,49,37.6,3172,1195,549,2.52,3.03,3294,3172,122,14,2585,587
S,Fort Belvoir CDP,7176,3607,3569,1056,1046,790,442,578,1700,1265,232,36,10,17,4,0,22.5,1904,1620,18,3.66,3.68,2056,1904,152,0,23,1881
S,Fort Chiswell CDP,911,452,459,60,60,59,72,57,139,159,135,37,43,58,22,10,35.9,357,133,69,2.54,2.94,380,357,23,3,274,83
S,Fort Hunt CDP,12923,6274,6649,855,998,897,596,223,809,2187,2324,887,673,1283,1002,189,44.6,4974,1706,1640,2.58,2.94,5050,4974,76,19,4641,333
S,Fort Lee CDP,7269,4139,3130,691,671,476,1152,1510,1796,808,140,10,4,7,2,2,21.7,1401,1032,10,3.27,3.53,1445,1401,44,0,34,1367
S,Franconia CDP,31907,15337,16570,2340,1999,1738,1360,1524,6619,7214,5225,1467,909,1039,396,77,35.4,13284,4181,1199,2.4,3.01,13509,13284,225,45,9411,3873
A,Franklin city,8346,3689,4657,424,613,665,613,424,869,1207,1147,455,393,718,553,265,39.9,3384,1168,991,2.39,2.93,3767,3384,383,25,1818,1566
A,Fredericksburg city,19279,8677,10602,1127,943,867,2104,2982,2856,2385,2138,791,616,1222,926,322,30.3,8102,1956,1918,2.09,2.81,8888,8102,786,43,2882,5220
A,Fries town,614,265,349,29,24,28,36,29,49,70,93,33,51,88,63,21,49.4,298,63,134,2.06,2.71,337,298,39,14,210,88
A,Front Royal town,13589,6435,7154,969,1020,971,831,807,1845,2061,1740,744,614,980,765,242,36.6,5425,1931,1457,2.46,3.01,5752,5425,327,23,3250,2175
S,Gainesville CDP,4382,2162,2220,409,300,247,161,184,799,811,560,254,221,315,100,21,35.9,1719,599,295,2.55,2.91,1842,1719,123,11,1578,141
A,Galax city,6837,3250,3587,439,440,430,418,387,875,928,900,404,306,670,459,181,39.8,2950,892,897,2.27,2.9,3217,2950,267,30,1954,996
A,Gate City town,2159,1009,1150,122,117,117,123,111,285,270,289,118,128,252,180,47,42.7,984,257,366,2.16,2.81,1119,984,135,11,671,313
A,Glade Spring town,1374,634,740,68,74,99,97,74,145,217,187,83,80,147,79,24,41,565,189,198,2.43,2.96,626,565,61,9,449,116
A,Glasgow town,1046,503,543,51,74,76,72,56,113,149,163,48,54,110,62,18,40.4,450,140,141,2.32,2.87,494,450,44,3,331,119
S,Glen Allen CDP,12562,5956,6606,893,859,848,754,641,2198,2461,1876,586,398,620,340,88,35.3,5131,1838,791,2.45,2.98,5297,5131,166,18,4133,998
A,Glen Lyn town,151,73,78,12,10,13,11,13,16,27,15,5,4,12,9,4,35.3,57,22,18,2.65,3.36,62,57,5,0,35,22
S,Gloucester Courthouse CDP,2269,974,1295,106,116,137,132,86,191,346,302,128,110,208,212,195,45.5,857,262,275,2.28,2.82,907,857,50,2,563,294
S,Gloucester Point CDP,9429,4626,4803,563,627,727,597,527,1270,1643,1376,577,412,652,367,91,37.6,3787,1352,833,2.49,2.9,4071,3787,284,69,2754,1033
A,Gordonsville town,1498,666,832,105,108,82,102,99,187,238,206,70,69,116,80,36,37.8,628,216,168,2.35,2.95,688,628,60,1,375,253
A,Goshen town,406,186,220,25,32,26,27,20,52,61,42,26,27,44,19,5,38.2,179,53,54,2.27,2.9,214,179,35,8,127,52
S,Great Falls CDP,8549,4332,4217,533,772,778,584,199,497,1391,1817,781,472,470,210,45,42.1,2785,1272,522,3.07,3.23,2852,2785,67,13,2648,137
S,Greenville CDP,886,574,312,27,36,51,42,57,175,197,128,33,38,64,30,8,37.1,234,85,72,2.66,2.95,251,234,17,3,202,32
A,Gretna town,1257,535,722,46,72,72,61,39,120,153,149,74,78,181,141,71,50,569,140,243,2.06,2.75,635,569,66,0,314,255
A,Grottoes town,2114,1000,1114,166,165,156,133,110,363,356,273,90,71,134,86,11,34.2,861,342,189,2.46,2.98,894,861,33,1,616,245
S,Groveton CDP,21296,10583,10713,1611,1512,1330,1230,1363,3744,4036,3093,938,665,935,646,193,34.7,8076,2904,1381,2.63,3.17,8275,8076,199,16,4568,3508
A,Grundy town,1105,523,582,39,80,140,127,48,96,141,149,50,51,99,56,29,37,405,97,141,2.28,2.72,519,405,114,9,262,143
A,Halifax town,1389,692,697,61,84,66,92,74,156,236,184,85,86,142,100,23,42.3,523,144,172,2.29,2.83,583,523,60,3,391,132
A,Hallwood town,290,146,144,21,37,21,23,12,42,35,34,16,13,18,14,4,32,100,41,29,2.9,3.38,121,100,21,3,75,25
A,Hamilton town,562,262,300,46,43,45,32,18,72,115,91,38,17,22,14,9,37.2,216,95,35,2.6,3.05,224,216,8,1,180,36
S,Hampden Sydney CDP,1264,1053,211,30,35,26,380,510,49,72,57,18,25,36,18,8,20.7,167,59,48,2.46,2.88,184,167,17,4,113,54
A,Hampton city,146437,72579,73858,9242,10073,10309,11242,13013,21662,25880,18133,6388,5352,8503,5305,1335,34,53887,19817,11038,2.49,3.02,57311,53887,3424,285,31570,22317
A,Harrisonburg city,40468,19171,21297,1905,1715,1612,6449,11108,4584,3992,3251,1175,910,1740,1456,571,22.6,13133,3320,2373,2.53,3,13689,13133,556,37,5125,8008
A,Haymarket town,879,462,417,96,83,60,36,42,177,195,87,32,39,19,11,2,32.5,321,147,24,2.74,3.21,337,321,16,3,236,85
A,Haysi town,186,83,103,11,6,12,18,7,15,31,29,11,10,20,12,4,42.3,80,23,28,2.33,2.84,99,80,19,6,64,16
A,Herndon town,21655,11413,10242,1711,1671,1525,1522,1642,4161,4132,3210,751,481,545,246,58,31.5,6962,3103,673,3.11,3.54,7190,6962,228,76,4585,2377
S,Highland Springs CDP,15137,6914,8223,1168,1306,1218,1089,902,2260,2445,2060,671,480,801,559,178,33.5,5788,2513,1105,2.59,3.03,6040,5788,252,8,3759,2029
A,Hillsboro town,96,44,52,5,8,4,5,5,11,16,13,11,5,6,6,1,41,39,11,12,2.46,2.75,41,39,2,2,30,9
A,Hillsville town,2607,1191,1416,139,132,136,141,194,295,325,368,162,107,304,199,105,43.3,1207,305,421,2.11,2.71,1352,1207,145,21,676,531
S,Hollins CDP,14309,6258,8051,656,838,784,976,806,1595,1906,2054,784,710,1439,1195,566,43,5722,1619,1908,2.26,2.8,5947,5722,225,19,4115,1607
A,Honaker town,945,426,519,45,74,57,66,55,122,146,155,55,41,69,45,15,38.8,392,129,106,2.41,2.98,445,392,53,3,282,110
A,Hopewell city,22354,10447,11907,1667,1777,1588,1509,1466,3162,3235,2659,1134,891,1747,1136,383,35,9055,3304,2331,2.43,2.94,9749,9055,694,16,5067,3988
S,Horse Pasture CDP,2255,1081,1174,114,132,148,132,93,253,369,317,163,140,240,129,25,42.1,957,285,293,2.36,2.83,1021,957,64,5,792,165
S,Huntington CDP,8325,4201,4124,384,321,251,219,740,2135,1463,1181,450,318,463,333,67,35.6,4615,617,689,1.8,2.75,4860,4615,245,107,1650,2965
A,Hurt town,1276,596,680,72,81,70,83,59,165,197,159,89,75,140,72,14,40.6,541,171,167,2.36,2.8,592,541,51,1,452,89
S,Hybla Valley CDP,16721,8060,8661,1290,1206,1219,1035,1119,2791,2728,2160,820,607,986,620,140,33.8,6362,2333,1242,2.61,3.18,6515,6362,153,10,3303,3059
S,Idylwood CDP,16005,8025,7980,1037,856,795,727,1237,3949,2804,2248,708,493,640,433,78,33.3,6560,1865,878,2.44,3.04,6727,6560,167,70,3323,3237
A,Independence town,971,436,535,39,31,38,52,49,96,109,111,50,59,130,145,62,51.3,426,86,193,1.98,2.73,497,426,71,17,232,194
A,Iron Gate town,404,198,206,12,27,14,26,21,38,59,59,24,28,57,31,8,46.2,185,41,72,2.18,2.73,197,185,12,1,154,31
A,Irvington town,673,298,375,18,23,32,28,9,24,65,79,40,43,108,121,83,62.8,240,52,111,2.19,2.61,325,240,85,56,208,32
A,Ivor town,320,153,167,13,19,21,19,13,29,49,40,31,17,35,29,5,44.4,135,40,54,2.37,2.78,152,135,17,1,103,32
A,Jarratt town,589,273,316,45,37,32,31,30,72,87,82,33,36,47,42,15,40.7,271,85,82,2.17,2.71,293,271,22,4,190,81
S,Jefferson CDP,27422,13771,13651,1887,1703,1511,1421,1778,5512,4973,3770,1382,1019,1359,926,181,34.8,10016,3248,1893,2.74,3.3,10227,10016,211,33,6586,3430
S,Jolivue CDP,1037,442,595,33,51,57,62,44,149,165,135,42,40,114,112,33,42.4,551,108,213,1.88,2.76,594,551,43,6,222,329
A,Jonesville town,995,464,531,67,38,48,47,64,121,125,148,41,64,126,86,20,44.2,497,118,181,1.91,2.66,565,497,68,11,254,243
A,Keller town,173,82,91,13,7,10,8,10,27,34,16,7,10,12,13,6,40.2,77,20,25,2.25,2.78,90,77,13,1,56,21
A,Kenbridge town,1253,630,623,65,70,73,123,66,152,136,177,86,62,112,95,36,41,529,140,187,2.24,2.83,579,529,50,6,371,158
S,Keokee CDP,316,165,151,13,19,33,17,18,38,50,51,13,18,26,16,4,39.6,128,50,39,2.47,3.02,147,128,19,3,108,20
A,Keysville town,817,330,487,44,59,41,40,32,86,106,89,40,34,94,92,60,45.1,359,99,133,2.03,2.79,398,359,39,5,181,178
A,Kilmarnock town,1244,507,737,49,70,70,59,39,102,138,124,68,60,159,191,115,52.5,547,139,246,1.99,2.66,607,547,60,8,340,207
A,La Crosse town,618,274,344,38,34,46,38,39,68,99,70,48,27,59,42,10,40.1,263,84,87,2.29,2.9,314,263,51,6,173,90
S,Lake Barcroft CDP,8906,4340,4566,545,527,482,379,371,1235,1418,1508,586,420,699,601,135,41.8,3589,1016,1017,2.48,2.97,3673,3589,84,22,2666,923
S,Lake Monticello CDP,6852,3295,3557,487,499,436,271,178,997,1128,789,390,426,928,282,41,39.4,2754,925,807,2.49,2.77,2950,2754,196,102,2486,268
S,Lake Ridge CDP,30404,14598,15806,2218,2420,2726,2347,1560,4566,5880,5012,1431,723,738,585,198,33.7,10980,4928,1114,2.76,3.21,11265,10980,285,17,7983,2997
S,Lakeside CDP,11157,5201,5956,673,674,595,472,588,1884,1933,1408,556,414,847,824,289,38.4,4982,1333,1356,2.19,2.8,5177,4982,195,10,3455,1527
S,Laurel CDP,14875,7183,7692,914,820,769,833,1256,3114,2616,1758,613,551,897,595,139,34.1,6288,1853,1108,2.24,2.87,6522,6288,234,22,3663,2625
S,Laurel Park CDP,781,364,417,51,55,55,45,62,110,125,126,69,32,39,8,4,35.9,331,127,38,2.36,2.87,342,331,11,1,204,127
A,Lawrenceville town,1275,553,722,52,51,62,247,232,114,109,150,45,37,88,70,18,24.7,376,108,137,2.35,3.16,459,376,83,3,219,157
S,Laymantown CDP,2034,988,1046,102,134,162,121,51,174,333,360,159,146,196,71,25,43.5,762,270,197,2.67,2.91,794,762,32,3,740,22
A,Lebanon town,3273,1535,1738,164,181,170,210,216,413,442,430,206,193,322,221,105,41.2,1420,386,448,2.14,2.76,1548,1420,128,5,883,537
A,Leesburg town,28311,13907,14404,2776,2520,1996,1482,1353,5172,5829,3560,1145,739,885,590,264,33.1,10325,4472,1145,2.69,3.2,10671,10325,346,48,7008,3317
A,Lexington city,6867,3791,3076,205,195,213,1302,1683,528,470,620,268,257,529,419,178,23.3,2232,447,751,2.06,2.76,2376,2232,144,13,1225,1007
S,Lincolnia CDP,15788,8047,7741,1262,1130,1004,949,1209,2806,2761,2218,683,511,694,453,108,33.3,5166,2074,884,3.03,3.45,5255,5166,89,10,2757,2409
S,Linton Hall CDP,8620,4288,4332,1233,864,660,392,281,2021,1968,780,174,93,109,36,9,30.3,2733,1597,101,3.12,3.34,2851,2733,118,2,2657,76
S,Loch Lomond CDP,3411,1762,1649,271,301,268,254,166,471,605,463,201,151,198,52,10,34.6,1048,485,190,3.25,3.51,1063,1048,15,0,971,77
S,Lorton CDP,17786,9891,7895,1338,1379,1186,906,1180,3816,4218,2444,547,310,267,140,55,32.9,5663,2534,316,2.68,3.21,5892,5663,229,15,3596,2067
A,Louisa town,1401,629,772,102,96,97,75,88,185,214,140,67,62,108,113,54,37.7,584,190,171,2.25,2.93,620,584,36,1,226,358
A,Lovettsville town,853,403,450,70,68,74,59,32,126,156,134,33,19,38,36,8,34.8,318,134,66,2.68,3.19,325,318,7,0,252,66
S,Low Moor CDP,367,187,180,19,25,25,19,11,49,62,57,15,19,34,30,2,40.8,150,53,55,2.45,2.91,161,150,11,1,123,27
A,Luray town,4871,2269,2602,267,325,309,290,212,610,704,555,289,274,514,353,169,40.7,2037,641,688,2.31,2.85,2191,2037,154,17,1322,715
A,Lynchburg city,65269,29841,35428,3817,4102,4192,5796,6644,7972,8530,8094,2923,2554,4888,3989,1768,35.1,25477,7868,7167,2.3,2.92,27640,25477,2163,134,14914,10563
S,Lyndhurst CDP,1527,750,777,80,80,133,111,63,169,248,238,122,83,116,58,26,40.3,580,201,147,2.61,3,602,580,22,4,509,71
A,McKenney town,441,226,215,25,29,18,27,25,55,65,64,25,25,32,35,16,42.1,167,56,62,2.43,3.11,183,167,16,3,113,54
S,McLean CDP,38929,18748,20181,2290,2768,2969,2373,1044,3022,6111,7282,2948,1896,3183,2392,651,43.4,14374,5362,4284,2.7,3.05,14735,14374,361,91,12248,2126
A,Madison town,210,99,111,7,13,12,13,9,26,27,28,9,10,32,14,10,44.6,109,29,45,1.93,2.65,115,109,6,2,50,59
S,Madison Heights CDP,11584,5547,6037,673,702,756,671,620,1534,1840,1736,666,627,1041,576,142,39.5,4451,1529,1242,2.45,2.88,4656,4451,205,12,3232,1219
A,Manassas city,35135,17868,17267,3020,3053,2776,2509,2486,6116,6464,4589,1348,872,1086,599,217,31.3,11757,5348,1325,2.92,3.39,12114,11757,357,29,8203,3554
A,Manassas Park city,10290,5242,5048,1024,906,810,691,660,2130,1994,1049,324,260,311,108,23,30.3,3254,1633,357,3.16,3.47,3365,3254,111,4,2560,694
S,Mantua CDP,7485,3598,3887,425,483,592,444,302,567,1097,1290,449,352,522,533,429,43.7,2627,996,830,2.7,3.15,2723,2627,96,11,1852,775
A,Marion town,6349,2974,3375,319,327,339,447,417,749,900,818,371,350,648,475,189,41.6,2647,704,937,2.13,2.76,2865,2647,218,10,1515,1132
A,Martinsville city,15416,6966,8450,867,969,1020,940,762,1778,2332,2020,789,760,1492,1197,490,40.8,6498,2001,2136,2.27,2.89,7249,6498,751,22,3914,2584
S,Massanutten CDP,1945,975,970,138,127,141,105,77,282,402,326,82,80,136,47,2,37.4,751,286,132,2.59,2.91,1051,751,300,274,657,94
S,Matoaca CDP,2273,1077,1196,147,179,194,140,98,279,397,327,111,82,162,126,31,37.7,866,337,232,2.62,3.03,911,866,45,1,702,164
S,Max Meadows CDP,512,241,271,27,25,28,43,33,66,67,93,33,16,58,15,8,41.4,206,66,59,2.49,2.91,235,206,29,6,183,23
S,Mechanicsville CDP,30464,14660,15804,2126,2389,2362,1882,1191,4567,5672,4181,1569,1110,1926,1156,333,36.2,11607,4816,2377,2.61,3,11915,11607,308,14,9486,2121
A,Melfa town,450,205,245,32,32,19,33,26,61,73,61,19,17,41,27,9,38,183,65,57,2.46,2.93,205,183,22,3,144,39
S,Merrifield CDP,11170,5650,5520,790,625,442,529,938,2803,1962,1574,486,333,458,187,43,32.8,4396,1316,532,2.54,3.06,4534,4396,138,29,2218,2178
S,Merrimac CDP,1751,789,962,90,93,77,64,170,276,214,148,64,57,132,212,154,39.9,889,178,310,1.82,2.76,934,889,45,2,332,557
A,Middleburg town,632,266,366,36,29,25,29,25,82,104,74,52,39,58,65,14,44.2,322,75,107,1.96,2.57,364,322,42,16,168,154
A,Middletown town,1015,479,536,63,96,79,59,59,140,194,132,43,33,56,47,14,35.5,409,157,89,2.48,2.96,432,409,23,5,284,125
A,Mineral town,424,212,212,26,30,23,33,22,52,63,61,25,16,36,30,7,39.5,172,60,55,2.47,3.09,196,172,24,3,119,53
S,Montclair CDP,15728,7742,7986,1159,1414,1582,1337,681,1923,3136,2795,788,382,368,139,24,34,5084,2731,406,3.09,3.35,5184,5084,100,9,4373,711
A,Monterey town,158,65,93,6,3,9,5,2,9,18,33,13,11,17,27,5,53.4,90,15,37,1.76,2.48,141,90,51,32,56,34
S,Montrose CDP,7018,3180,3838,548,590,499,475,535,1107,1203,911,257,210,361,252,70,32.7,2924,1136,546,2.4,2.97,3081,2924,157,9,1556,1368
A,Montross town,315,132,183,12,20,18,14,9,25,48,44,26,21,40,28,10,48.5,151,40,59,2.05,2.59,164,151,13,4,123,28
A,Mount Crawford town,254,124,130,8,12,22,23,10,28,57,29,14,16,15,17,3,40,104,33,24,2.44,2.81,109,104,5,0,64,40
A,Mount Jackson town,1664,821,843,121,128,107,103,106,227,264,211,69,65,141,101,21,36.4,667,228,204,2.49,3.01,718,667,51,3,431,236
S,Mount Vernon CDP,28582,13870,14712,2079,2117,2078,1838,1656,4119,5152,4317,1490,1156,1549,897,134,35.8,10575,4032,1841,2.7,3.16,10926,10575,351,27,6777,3798
A,Narrows town,2111,970,1141,131,135,134,132,103,284,313,251,142,98,180,169,39,39.4,890,281,283,2.35,2.9,971,890,81,6,690,200
A,Nassawadox town,572,256,316,36,27,31,27,22,38,46,68,20,23,78,76,80,53.5,186,55,85,2.33,2.93,207,186,21,6,124,62
A,New Castle town,179,81,98,17,11,8,10,17,23,19,20,14,11,21,5,3,36.8,85,24,20,2.11,2.73,93,85,8,1,44,41
S,Newington CDP,19784,9695,10089,1470,1679,1590,1343,811,2537,3859,3520,1056,582,596,519,222,36.3,6710,3063,972,2.93,3.28,6793,6710,83,5,5264,1446
A,New Market town,1637,773,864,88,80,89,85,95,203,218,220,108,93,187,138,33,43.3,737,179,261,2.13,2.72,808,737,71,18,408,329
A,Newport News city,180150,87178,92972,14228,14404,13457,13136,14930,28448,29485,20773,7375,5761,9758,6515,1880,32,69686,27420,13222,2.5,3.04,74117,69686,4431,226,36513,33173
A,Newsoms town,282,120,162,13,19,12,26,10,34,43,37,15,13,24,28,8,41.5,124,37,50,2.27,2.9,141,124,17,5,87,37
A,Nickelsville town,448,196,252,31,29,22,31,29,47,50,75,24,19,45,32,14,42.9,184,55,60,2.33,2.97,210,184,26,1,112,72
S,Nokesville CDP,1236,621,615,61,73,119,105,52,113,208,203,108,57,84,48,5,40.7,439,167,99,2.82,3.09,462,439,23,2,364,75
A,Norfolk city,234403,119830,114573,16546,16508,15072,18926,31983,36620,33569,25010,8143,6494,12979,9693,2860,29.6,86210,30086,18877,2.45,3.07,94416,86210,8206,282,39238,46972
S,North Shore CDP,2112,1054,1058,51,68,91,68,52,148,241,401,268,228,352,125,19,53.6,994,169,336,2.12,2.44,1919,994,925,861,885,109
S,North Springfield CDP,9173,4608,4565,657,675,559,486,403,1277,1730,1297,505,379,703,440,62,37.7,3251,1219,827,2.82,3.19,3291,3251,40,9,2570,681
A,Norton city,3904,1757,2147,201,261,239,250,299,509,557,580,212,200,316,204,76,39,1730,516,456,2.23,2.88,1946,1730,216,1,967,763
S,Oak Level CDP,885,447,438,50,45,44,44,34,117,117,143,62,69,91,59,10,44.3,415,105,118,2.13,2.6,465,415,50,7,331,84
S,Oakton CDP,29348,14487,14861,1926,1931,1819,1706,1721,5000,5232,4874,1741,1188,1384,657,169,36.1,11118,3821,1564,2.63,3.08,11392,11118,274,77,7300,3818
A,Occoquan town,759,357,402,32,18,21,28,46,131,144,159,60,36,64,15,5,41.6,418,52,70,1.82,2.54,443,418,25,4,242,176
A,Onancock town,1525,679,846,87,80,98,91,71,130,200,226,68,73,179,164,58,45.3,656,184,276,2.19,2.82,733,656,77,27,411,245
A,Onley town,496,227,269,23,26,28,25,16,42,81,70,31,25,72,37,20,46.3,223,57,98,2.22,2.72,271,223,48,7,166,57
A,Orange town,4123,1907,2216,281,253,257,236,242,612,610,476,164,179,342,314,157,37.7,1607,547,499,2.28,2.87,1712,1607,105,7,809,798
A,Painter town,246,106,140,18,16,11,20,14,25,32,21,16,11,33,21,8,40.6,104,31,47,2.37,2.99,117,104,13,2,84,20
A,Pamplin City town,199,95,104,17,17,17,19,7,23,36,13,7,5,19,10,9,34.5,78,31,31,2.55,3.27,89,78,11,2,47,31
A,Parksley town,837,388,449,39,57,64,52,32,103,132,101,41,36,92,77,11,40.6,363,111,133,2.31,2.87,405,363,42,8,256,107
S,Patrick Springs CDP,2068,999,1069,125,128,131,145,97,267,300,293,155,123,143,136,25,39.5,872,281,231,2.37,2.83,966,872,94,20,681,191
A,Pearisburg town,2729,1282,1447,162,173,173,142,137,348,380,362,176,135,258,233,50,40.8,1219,362,419,2.23,2.77,1279,1219,60,6,834,385
A,Pembroke town,1134,543,591,65,80,69,55,51,181,173,146,66,56,102,62,28,37.9,491,150,151,2.31,2.89,520,491,29,3,369,122
S,Penhook CDP,726,363,363,28,42,38,33,23,58,108,111,84,59,111,24,7,48.6,308,73,99,2.36,2.65,694,308,386,356,271,37
A,Pennington Gap town,1781,799,982,99,101,105,94,94,210,243,247,114,90,176,157,51,42.5,811,210,279,2.15,2.84,950,811,139,3,448,363
A,Petersburg city,33740,15426,18314,2165,2433,2522,2226,2151,4393,4883,4460,1759,1501,2692,1897,658,36.9,13799,4667,3779,2.38,2.98,15955,13799,2156,23,7107,6692
A,Phenix town,200,95,105,5,7,11,21,14,19,25,31,10,10,29,16,2,44.3,78,22,34,2.56,2.89,94,78,16,0,66,12
S,Pimmit Hills CDP,6152,3117,3035,339,362,401,345,402,1070,1147,882,319,247,404,200,34,36.3,2258,730,487,2.72,3.2,2299,2258,41,6,1563,695
A,Pocahontas town,441,208,233,35,30,29,26,27,44,49,72,16,34,45,28,6,41.3,190,60,61,2.32,2.98,230,190,40,3,128,62
A,Poquoson city,11566,5789,5777,587,863,1051,876,463,1041,2052,1953,778,588,766,392,156,39.5,4166,1743,907,2.75,3.08,4300,4166,134,23,3503,663
A,Port Royal town,170,85,85,16,12,10,9,11,22,28,21,8,1,14,14,4,37,72,26,24,2.36,2.89,90,72,18,3,56,16
A,Portsmouth city,100565,48583,51982,7171,7294,7167,7337,8012,14105,15180,12369,4315,3761,6879,5422,1553,34.5,38170,13987,10167,2.51,3.05,41605,38170,3435,121,22356,15814
A,Pound town,1089,509,580,82,70,71,72,62,125,199,148,42,44,92,65,17,39,455,157,135,2.39,2.88,516,455,61,7,301,154
A,Pulaski town,9473,4428,5045,578,606,543,560,497,1287,1300,1345,543,480,863,667,204,40.3,4173,1224,1278,2.24,2.8,4517,4173,344,21,2465,1708
A,Purcellville town,3584,1734,1850,310,382,326,216,102,482,707,426,148,115,183,139,48,34.7,1253,603,253,2.84,3.28,1292,1253,39,5,972,281
A,Quantico town,561,309,252,46,34,24,23,55,97,126,72,20,17,27,14,6,35.1,295,64,44,1.9,3.02,359,295,64,3,50,245
S,Quantico Station CDP,6571,4030,2541,948,638,380,418,1702,1474,858,136,8,1,6,2,0,22.4,1389,1078,6,3.57,3.57,1645,1389,256,1,77,1312
A,Radford city,15859,7215,8644,561,547,592,2719,4605,1710,1392,1304,531,433,770,538,157,22.8,5809,1200,1099,2.25,2.78,6137,5809,328,30,2588,3221
S,Raven CDP,2593,1260,1333,169,182,157,160,167,372,376,384,172,126,204,101,23,37.3,1064,372,264,2.44,2.88,1219,1064,155,3,840,224
A,Remington town,624,287,337,51,52,47,39,49,98,118,83,27,17,25,14,4,32.9,238,93,37,2.6,3.02,255,238,17,2,106,132
S,Reston CDP,56407,27565,28842,3932,3526,3334,2803,2978,10353,10104,9311,3715,2228,2346,1206,571,36.2,23320,7294,2941,2.4,2.99,24210,23320,890,319,15557,7763
A,Rich Creek town,665,310,355,27,34,31,30,27,74,81,98,48,35,78,64,38,47.5,277,70,93,2.19,2.71,312,277,35,0,194,83
A,Richlands town,4144,1866,2278,218,211,243,267,239,493,654,643,208,201,439,261,67,41.4,1882,536,604,2.2,2.76,2137,1882,255,3,1292,590
A,Richmond city,197790,92068,105722,12376,12765,11713,13870,18386,32871,29841,24985,8208,6646,12843,9764,3522,33.9,84549,23459,19421,2.21,2.95,92282,84549,7733,249,39008,45541
A,Ridgeway town,775,359,416,42,60,59,53,30,94,121,108,50,62,59,30,7,38.9,310,112,80,2.5,3.01,327,310,17,0,256,54
A,Roanoke city,94911,44501,50410,6200,6381,5802,5072,5746,14400,14548,13098,4555,3549,7366,5996,2198,37.6,42003,12211,11180,2.2,2.86,45257,42003,3254,175,23637,18366
A,Rocky Mount town,4066,1868,2198,231,243,258,225,228,466,557,517,199,182,410,378,172,41.9,1698,492,598,2.21,2.87,1796,1698,98,9,1001,697
S,Rose Hill CDP,15058,7399,7659,1032,975,899,770,602,2240,2885,2500,961,643,942,539,70,38.4,5683,1950,1123,2.65,3.09,5783,5683,100,13,4670,1013
S,Rose Hill CDP,714,304,410,45,51,60,41,22,78,133,79,49,46,49,44,17,39.4,306,99,87,2.33,2.96,344,306,38,3,228,78
A,Round Hill town,500,251,249,52,47,39,26,17,61,104,71,18,26,16,19,4,35.8,173,79,32,2.89,3.22,177,173,4,0,144,29
A,Rural Retreat town,1350,635,715,83,77,93,83,102,178,196,168,77,73,123,77,20,38.4,570,186,170,2.37,2.84,629,570,59,6,440,130
S,Rushmere CDP,1083,540,543,69,63,54,70,39,101,207,184,84,55,91,47,19,42.2,435,141,115,2.49,2.95,529,435,94,56,346,89
S,Rustburg CDP,1271,666,605,53,89,88,79,71,193,216,168,67,70,120,44,13,37.4,474,159,126,2.41,3,518,474,44,1,353,121
A,St. Charles town,159,75,84,13,12,17,10,15,28,17,22,5,3,7,9,1,30.4,61,28,16,2.61,3.02,72,61,11,0,45,16
A,St. Paul town,1000,453,547,61,70,57,54,71,109,132,163,41,46,112,61,23,41.6,464,140,153,2.16,2.72,496,464,32,3,265,199
A,Salem city,24747,11677,13070,1212,1458,1546,1979,1857,2909,3708,3456,1328,1146,2182,1478,488,39.2,9954,3024,2811,2.32,2.84,10403,9954,449,41,6730,3224
A,Saltville town,2204,1040,1164,118,146,159,124,121,272,358,309,100,118,215,133,31,39.4,909,312,294,2.4,2.88,1003,909,94,5,700,209
S,Sandy Level CDP,689,315,374,49,40,59,58,47,103,83,98,33,37,43,33,6,34.1,256,106,64,2.69,3.22,277,256,21,3,211,45
A,Saxis town,337,162,175,7,22,14,19,12,31,52,54,19,19,44,31,13,47.3,148,34,64,2.28,2.71,193,148,45,22,127,21
A,Scottsburg town,145,68,77,15,11,12,9,6,24,19,18,7,6,7,11,0,33.8,56,24,13,2.59,3.13,64,56,8,3,37,19
A,Scottsville town,555,256,299,31,30,48,24,29,77,88,66,43,23,56,32,8,39.5,256,71,73,2.17,2.82,300,256,44,11,135,121
S,Selma CDP,485,247,238,22,38,45,18,22,63,58,66,26,31,57,36,3,40.8,196,63,72,2.47,3.01,217,196,21,2,167,29
S,Seven Corners CDP,8701,4522,4179,657,529,408,475,780,2007,1610,1082,369,246,326,168,44,32.3,3304,1056,430,2.62,3.3,3378,3304,74,17,1127,2177
S,Shawsville CDP,1029,516,513,82,74,67,58,70,177,148,149,62,39,67,25,11,33.9,431,163,80,2.39,2.79,443,431,12,0,339,92
A,Shenandoah town,1878,881,997,115,133,135,118,100,266,291,267,89,71,166,102,25,37.6,764,264,218,2.46,2.87,812,764,48,7,554,210
S,Sherando CDP,665,330,335,46,51,33,39,28,91,136,93,38,39,46,18,7,37.9,270,96,55,2.46,2.73,281,270,11,3,231,39
S,Short Pump CDP,182,94,88,12,14,16,11,7,22,39,19,3,11,10,16,2,36.5,69,24,18,2.64,3.3,77,69,8,0,51,18
A,Smithfield town,6324,2983,3341,453,475,492,416,311,730,1124,920,294,247,452,290,120,37.7,2438,997,582,2.55,2.95,2552,2438,114,14,1677,761
A,South Boston town,8491,3750,4741,566,568,554,502,391,979,1151,1165,477,389,759,675,315,41.2,3502,1151,1083,2.26,2.9,3946,3502,444,23,2134,1368
A,South Hill town,4403,1924,2479,269,299,270,288,229,514,644,570,197,245,435,295,148,39.9,1809,573,559,2.33,2.88,1988,1809,179,15,1056,753
S,Spotsylvania Courthouse CDP,3833,1907,1926,295,389,394,342,194,525,755,501,150,94,130,54,10,31.5,1233,677,154,3.11,3.42,1268,1233,35,2,1005,228
S,Springfield CDP,30417,15144,15273,2097,2034,1880,1784,1775,4939,5462,4488,1482,1077,1761,1325,313,36.2,10495,3796,2443,2.88,3.37,10832,10495,337,22,7464,3031
A,Stanardsville town,476,203,273,34,31,34,21,24,56,51,36,25,24,54,44,42,41.1,183,67,57,2.21,2.73,196,183,13,4,68,115
A,Stanley town,1326,619,707,82,89,86,105,85,185,186,146,83,68,108,87,16,36.9,562,179,172,2.36,2.95,598,562,36,1,313,249
S,Stanleytown CDP,1515,779,736,66,68,84,82,102,176,235,168,101,119,197,86,31,42.2,662,164,233,2.29,2.73,723,662,61,3,508,154
A,Staunton city,23853,11237,12616,1241,1285,1331,1652,1661,3104,3531,3345,1282,1121,2113,1601,586,39.8,9676,2663,2938,2.19,2.81,10427,9676,751,38,5939,3737
A,Stephens City town,1146,531,615,72,80,76,70,75,186,187,148,71,54,62,43,22,35.6,500,150,103,2.29,2.97,546,500,46,3,238,262
A,Stony Creek town,202,99,103,7,7,16,6,6,31,29,33,12,12,20,14,9,44.8,99,17,34,2.04,2.71,118,99,19,1,68,31
A,Strasburg town,4017,1874,2143,259,312,271,237,196,616,668,479,196,167,342,211,63,36.7,1773,588,486,2.27,2.87,1877,1773,104,6,924,849
A,Stuart town,961,443,518,53,54,65,73,59,100,146,103,65,53,82,84,24,40.1,449,124,152,2.09,2.85,516,449,67,5,224,225
S,Stuarts Draft CDP,8367,4036,4331,566,648,688,588,420,1152,1476,1158,434,330,522,288,97,36,3124,1286,619,2.66,3,3279,3124,155,10,2493,631
S,Sudley CDP,7719,3825,3894,613,654,651,513,488,1321,1385,1073,397,262,261,87,14,32.3,2640,1181,295,2.92,3.3,2703,2640,63,7,2113,527
A,Suffolk city,63677,30410,33267,4618,5076,5223,4269,3049,8514,11313,8505,3283,2559,3988,2496,784,36,23283,9713,5274,2.69,3.09,24704,23283,1421,70,16815,6468
S,Sugar Grove CDP,741,361,380,46,57,49,39,37,138,91,95,45,27,56,49,12,35.4,320,107,88,2.32,2.8,365,320,45,9,237,83
A,Surry town,262,130,132,19,12,19,15,14,31,56,34,14,8,13,24,3,39.1,109,36,29,2.4,2.83,119,109,10,3,77,32
A,Tangier town,604,304,300,30,29,50,33,28,53,94,106,30,39,72,32,8,42.7,244,78,89,2.48,2.94,270,244,26,8,227,17
A,Tappahannock town,2068,907,1161,103,162,130,115,129,287,271,235,97,97,197,157,88,38.7,857,265,246,2.23,2.91,946,857,89,32,500,357
A,Tazewell town,4206,2016,2190,208,225,199,242,250,533,572,612,257,195,411,325,177,43.3,1650,477,539,2.25,2.81,1804,1650,154,23,1111,539
A,The Plains town,266,127,139,18,15,15,10,13,30,55,40,15,15,22,14,4,41.8,110,32,30,2.42,3.01,118,110,8,2,49,61
S,Timberlake CDP,10683,5140,5543,590,682,728,623,695,1499,1684,1470,678,596,922,430,86,38.2,4523,1426,1025,2.36,2.83,4707,4523,184,14,3313,1210
A,Timberville town,1739,805,934,86,114,122,103,83,230,256,217,85,73,166,137,67,40,735,226,247,2.29,2.89,770,735,35,3,462,273
A,Toms Brook town,255,121,134,11,17,16,25,12,33,50,39,18,10,9,13,2,37.3,100,33,20,2.55,3.07,103,100,3,1,69,31
S,Triangle CDP,5500,2780,2720,534,409,387,356,570,951,939,643,200,170,219,108,14,30,2196,825,256,2.5,3.13,2318,2196,122,4,809,1387
A,Troutdale town,1230,1131,99,9,12,6,33,235,468,283,100,19,24,29,9,3,30.8,79,20,29,2.46,2.93,111,79,32,18,63,16
A,Troutville town,432,210,222,25,19,24,24,22,56,59,70,26,21,49,33,4,43.4,194,54,64,2.23,2.69,202,194,8,1,142,52
S,Tuckahoe CDP,43242,20159,23083,2427,2831,2994,2531,2110,5377,6608,6603,2276,1809,3782,2895,999,40.4,18126,5649,5122,2.36,2.92,18647,18126,521,62,12353,5773
S,Tysons Corner CDP,18540,8910,9630,1078,920,813,759,1214,4167,3305,2615,1039,739,1066,674,151,35.8,8814,1924,1506,2.1,2.86,9474,8814,660,376,4140,4674
S,Union Hall CDP,957,485,472,33,37,44,52,32,75,127,173,115,98,118,46,7,50.6,407,96,118,2.35,2.6,813,407,406,368,352,55
A,Urbanna town,543,224,319,18,25,41,25,12,46,70,82,48,38,71,47,20,48.7,266,59,107,2.04,2.61,354,266,88,55,189,77
S,Vansant CDP,989,466,523,37,60,59,53,44,113,162,166,79,70,90,37,19,43.2,436,122,115,2.27,2.73,500,436,64,5,317,119
S,Verona CDP,3638,1798,1840,226,243,264,257,192,487,577,567,214,187,281,107,36,37.7,1509,525,331,2.41,2.9,1562,1509,53,5,1129,380
A,Victoria town,1821,840,981,92,123,125,119,101,189,228,252,103,106,184,161,38,42.3,803,240,298,2.27,2.85,903,803,100,12,575,228
A,Vienna town,14453,7205,7248,941,951,942,822,481,1767,2643,2319,916,700,1192,644,135,40,5331,1887,1411,2.71,3.08,5438,5331,107,21,4625,706
S,Villa Heights CDP,845,413,432,59,45,54,50,69,134,111,97,43,41,87,44,11,36.1,343,107,110,2.46,2.98,358,343,15,0,232,111
A,Vinton town,7782,3579,4203,494,499,477,498,463,1068,1186,1086,386,341,594,467,223,37.9,3327,1098,866,2.29,2.82,3471,3327,144,7,2056,1271
A,Virgilina town,159,72,87,5,10,13,4,6,14,27,18,14,6,23,13,6,46.3,76,15,33,2.09,2.91,86,76,10,0,61,15
A,Virginia Beach city,425257,210524,214733,30616,33523,33749,30239,31313,69842,75897,53798,17465,12882,20735,11649,3549,32.7,154455,64971,25377,2.7,3.14,162277,154455,7822,2344,101308,53147
A,Wachapreague town,236,110,126,4,1,4,11,7,22,26,38,19,21,41,32,10,55.6,133,13,65,1.77,2.32,225,133,92,73,107,26
A,Wakefield town,1038,482,556,62,82,67,77,34,118,152,142,61,52,82,88,21,40.5,423,145,148,2.45,3.05,485,423,62,9,282,141
A,Warrenton town,6670,3061,3609,431,469,449,381,307,930,1140,846,288,265,480,459,225,38.1,2683,876,702,2.33,3.01,2856,2683,173,16,1547,1136
A,Warsaw town,1375,695,680,42,52,56,68,98,202,185,169,51,47,132,151,122,44.1,445,106,172,2.01,2.81,468,445,23,3,258,187
A,Washington town,183,77,106,7,4,8,9,11,16,23,38,19,12,14,20,2,50.1,88,17,26,2.08,2.69,117,88,29,16,61,27
A,Waverly town,2309,1082,1227,123,173,181,155,93,275,340,307,121,112,211,130,88,39.6,880,312,256,2.47,3.09,960,880,80,10,594,286
A,Waynesboro city,19520,9140,10380,1282,1351,1306,1148,1113,2510,2840,2515,1081,933,1737,1297,407,38.9,8332,2697,2365,2.31,2.85,8863,8332,531,21,5103,3229
A,Weber City town,1333,584,749,65,65,52,73,73,140,159,165,92,80,182,115,72,47.3,605,137,226,2.08,2.64,689,605,84,3,362,243
S,West Gate CDP,7493,3829,3664,683,642,581,512,600,1425,1298,733,268,238,272,159,82,30.2,2473,1094,418,3.03,3.53,2544,2473,71,7,1207,1266
S,Westlake Corner CDP,899,466,433,35,38,58,28,34,96,114,125,94,81,137,51,8,49.5,389,91,124,2.31,2.51,515,389,126,108,312,77
A,West Point town,2866,1351,1515,170,204,237,177,107,330,401,436,171,121,262,185,65,39.4,1068,413,329,2.59,3,1151,1068,83,12,813,255
S,West Springfield CDP,28378,13845,14533,1658,2054,2241,1871,1211,3137,5189,5016,1862,1329,1946,750,114,39,10289,4009,1993,2.76,3.16,10425,10289,136,35,8544,1745
S,Weyers Cave CDP,1225,626,599,82,98,96,90,43,156,217,190,71,43,74,55,10,36.8,462,175,98,2.65,3.06,490,462,28,3,385,77
A,White Stone town,358,168,190,18,14,23,28,13,31,60,52,22,19,38,33,7,42.5,163,48,61,2.2,2.73,187,163,24,7,132,31
A,Williamsburg city,11998,5382,6616,326,304,307,2235,3500,1158,967,957,429,411,713,520,171,22.6,3619,665,952,2.07,2.66,3880,3619,261,65,1602,2017
A,Winchester city,23585,11434,12151,1432,1457,1381,1783,2156,3514,3510,3009,1037,875,1825,1235,371,35.2,10001,2868,2533,2.28,2.93,10587,10001,586,57,4567,5434
A,Windsor town,916,430,486,46,70,71,51,48,124,142,141,67,42,52,47,15,38,389,130,89,2.35,2.87,422,389,33,2,328,61
A,Wise town,3255,1639,1616,153,181,191,207,276,479,520,425,184,152,257,174,56,38,1424,393,384,2.17,2.79,1594,1424,170,15,935,489
S,Wolf Trap CDP,14001,6974,7027,1017,1176,1216,891,363,897,2424,2727,1238,829,874,280,69,41.2,4566,2129,848,3.07,3.19,4606,4566,40,10,4357,209
S,Woodbridge CDP,31941,16166,15775,2862,2824,2475,2292,2543,5749,5641,3344,1105,970,1363,583,190,30.3,10687,4935,1494,2.96,3.4,11026,10687,339,16,6293,4394
S,Woodlawn CDP,2249,1146,1103,116,129,126,115,119,308,371,382,147,109,214,91,22,40.8,847,243,238,2.31,2.77,926,847,79,18,680,167
A,Woodstock town,3952,1774,2178,219,233,226,209,203,476,494,443,192,195,420,436,206,43.4,1685,471,634,2.17,2.76,1840,1685,155,30,974,711
S,Wyndham CDP,6176,3088,3088,773,684,543,258,70,835,1585,821,191,145,189,72,10,34.5,2068,1150,189,2.99,3.32,2190,2068,122,11,1830,238
A,Wytheville town,7804,3423,4381,420,367,420,469,372,950,1028,1092,470,438,828,638,312,43.8,3504,898,1127,2.11,2.72,3776,3504,272,29,2119,1385
S,Yorkshire CDP,6732,3478,3254,680,549,468,441,474,1330,1290,706,262,209,225,74,24,31,2266,1044,252,2.97,3.32,2332,2266,66,9,1514,752
S,Yorktown CDP,203,98,105,2,6,9,3,12,23,35,30,18,18,28,14,5,48.4,117,11,38,1.74,2.63,129,117,12,2,46,71
S,Charlottesville MSA,159576,75888,83688,9385,10117,10401,12765,16009,22766,24738,21179,7431,6032,10324,6293,2136,34.3,61688,19734,12842,2.43,2.97,65315,61688,3627,940,38705,22983
S,Danville MSA,110156,52170,57986,6424,6926,7531,7284,5658,13006,17094,16179,6352,5341,9702,6574,2085,40,45291,14773,13305,2.39,2.91,51119,45291,5828,1081,31742,13549
S,Johnson City--Kingsport--Bristol--VA MSA (VA part),91873,43911,47962,4724,5301,5597,5717,5334,11451,13941,13508,5707,5032,8471,5285,1805,40.7,38529,11571,11182,2.32,2.82,42809,38529,4280,830,28909,9620
S,Lynchburg MSA,214911,103075,111836,12503,14159,14906,15452,14087,26756,33327,30678,11966,9996,16752,10563,3766,38,84414,28277,21556,2.43,2.92,92229,84414,7815,1722,62349,22065
S,Norfolk--Virginia Beach--Newport News--NC MSA (VA part),1551351,764006,787345,108122,117243,117723,115173,125370,228150,263903,195551,67630,53069,87775,55444,16198,33.5,570757,225778,114366,2.6,3.08,608648,570757,37891,5491,358199,212558
S,Richmond--Petersburg MSA,996512,478869,517643,64837,72165,72316,68962,61421,144027,170582,145434,48737,35950,59859,39433,12789,35.8,387721,140975,79727,2.48,3.02,410394,387721,22673,1460,262300,125421
S,Roanoke MSA,235932,111940,123992,13714,15312,15453,14436,12422,30449,37541,36036,12882,10322,19206,13436,4723,39.4,98343,30722,25787,2.33,2.87,104352,98343,6009,677,67418,30925
S,Washington--Baltimore DC--MD--VA--WV CMSA (VA part),2167757,1075927,1091830,157434,159007,151689,132182,128465,365967,402745,322240,108653,71148,94134,56552,17541,34.7,805642,300975,121654,2.65,3.19,835754,805642,30112,7017,538975,266667
S,Washington DC--MD--VA--WV PMSA (VA part),2167757,1075927,1091830,157434,159007,151689,132182,128465,365967,402745,322240,108653,71148,94134,56552,17541,34.7,805642,300975,121654,2.65,3.19,835754,805642,30112,7017,538975,266667
T,Mattaponi (state) Reservation,58,27,31,2,4,5,3,4,5,9,11,3,3,5,3,1,42,27,8,7,2.15,2.72,28,27,1,0,25,2
T,Pamunkey (state) Reservation,58,29,29,1,1,3,3,1,2,13,9,4,3,11,7,0,50.5,30,6,12,1.93,2.4,36,30,6,2,30,0
S,Chickahominy SDAISA,3313,1641,1672,184,194,219,224,188,402,606,537,225,143,254,115,22,38.8,1251,447,309,2.65,3.04,1311,1251,60,5,1095,156
S,Eastern Chickahominy SDAISA,104,51,53,6,3,13,8,3,15,18,14,8,1,5,5,5,38,40,14,14,2.6,3.18,42,40,2,0,34,6
N,Congressional District 1 (106th Congress),709060,348614,360446,45121,51683,53890,50161,44165,91675,122841,97498,37079,29267,47574,28867,9239,36.5,262613,100068,60091,2.6,3.05,292453,262613,29840,13476,194375,68238
N,Congressional District 2 (106th Congress),574058,289545,284513,40779,43117,42131,42299,55257,94129,96238,68766,22444,16833,28889,17879,5297,31.7,207877,82791,37086,2.63,3.12,220429,207877,12552,2533,126361,81516
N,Congressional District 3 (106th Congress),567683,268773,298910,40008,42888,41062,42115,46740,84847,90223,71843,24658,19742,33646,22361,7550,33.3,224993,80037,47185,2.43,3.03,244439,224993,19446,1244,116168,108825
N,Congressional District 4 (106th Congress),645733,317375,328358,42567,47802,50105,46898,40025,87236,110933,87794,31466,25361,40979,26678,7889,35.8,233963,93679,54318,2.62,3.08,251462,233963,17499,1437,163813,70150
N,Congressional District 5 (106th Congress),620104,300488,319616,34791,38619,41218,43128,41079,78150,96086,87798,35457,30321,51305,31881,10271,38.5,246757,79495,66624,2.41,2.91,280409,246757,33652,12148,180226,66531
N,Congressional District 6 (106th Congress),609802,292872,316930,34882,38197,39249,45560,46345,76354,92130,85901,32578,27063,47727,32414,11402,37.7,241584,76807,63371,2.39,2.9,261258,241584,19674,4731,166779,74805
N,Congressional District 7 (106th Congress),699196,339989,359207,45359,50901,52284,46494,35830,97418,124322,106670,35771,26014,42491,27201,8441,36.7,267736,100482,54228,2.55,3.03,281789,267736,14053,3433,200431,67305
N,Congressional District 8 (106th Congress),627849,310312,317537,39851,36976,33840,30527,41699,126148,113722,93513,31859,20939,30305,21713,6757,35.4,263688,73457,43039,2.34,3.05,273128,263688,9440,2588,143323,120365
N,Congressional District 9 (106th Congress),582943,287281,295662,30412,33420,34800,44020,49802,76075,85639,83587,33211,28253,45712,28410,9602,37.8,234526,72321,60359,2.38,2.85,262067,234526,27541,6927,172720,61806
N,Congressional District 10 (106th Congress),792534,393525,399009,61650,64278,61121,50409,38934,120516,151343,116397,39928,26763,35591,19583,6021,35,284781,119006,43869,2.76,3.18,299719,284781,14938,5010,216673,68108
N,Congressional District 11 (106th Congress),649553,323121,326432,46562,47203,46255,42454,40698,104417,117213,99489,33991,22613,28237,15624,4797,34.7,230655,90593,35034,2.78,3.24,237039,230655,6384,1169,157070,73585
